//MAP CONVERTED BY dmm2tgm.py THIS HEADER COMMENT PREVENTS RECONVERSION, DO NOT REMOVE
"a" = (
/turf/closed/wall/mineral/titanium,
/area/shuttle/mining)
"b" = (
/obj/effect/spawner/structure/window/shuttle,
/obj/machinery/door/firedoor,
/turf/open/floor/plating,
/area/shuttle/mining)
"c" = (
/obj/structure/table/reinforced,
/obj/item/storage/toolbox/emergency/old,
/turf/open/floor/iron/dark/textured_large,
/area/shuttle/mining)
"d" = (
/obj/machinery/computer/helm,
/turf/open/floor/iron/dark/textured_large,
/area/shuttle/mining)
"e" = (
/obj/structure/window/reinforced,
/turf/open/floor/iron/dark/textured_large,
/area/shuttle/mining)
"f" = (
/obj/structure/chair/comfy/shuttle{
	dir = 4
	},
/obj/structure/fluff/broken_flooring{
	icon_state = "pile";
	dir = 8
	},
/turf/open/floor/plating,
/area/shuttle/mining)
"g" = (
/obj/machinery/light{
	dir = 8
	},
/obj/item/storage/overmap_emergency_safe/electric{
	pixel_x = -22
	},
/obj/effect/turf_decal/siding/thinplating/dark{
	dir = 1
	},
/obj/structure/chair/comfy/shuttle{
	dir = 4
	},
/turf/open/floor/iron,
/area/shuttle/mining)
"h" = (
/obj/machinery/door/airlock/titanium{
	name = "Mining Shuttle Airlock"
	},
/obj/docking_port/mobile{
	dir = 8;
	dwidth = 3;
	height = 5;
	name = "mining shuttle";
	port_direction = 4;
	width = 7
	},
/obj/structure/fans/tiny,
/obj/machinery/door/firedoor,
/turf/open/floor/plating,
/area/shuttle/mining)
"i" = (
/obj/structure/ore_box,
/obj/effect/turf_decal/box,
/turf/open/floor/iron,
/area/shuttle/mining)
"j" = (
/obj/effect/turf_decal/box,
/obj/structure/closet/crate/internals,
/obj/item/clothing/suit/hazardvest{
	name = "safety vest"
	},
/obj/item/clothing/suit/hazardvest{
	name = "safety vest"
	},
/obj/item/clothing/head/hardhat/orange{
	name = "safety hard hat"
	},
/obj/item/clothing/head/hardhat/orange{
	name = "safety hard hat"
	},
/obj/item/tank/internals/oxygen/yellow,
/obj/item/tank/internals/oxygen/yellow,
/obj/item/clothing/mask/breath,
/obj/item/clothing/mask/breath,
/turf/open/floor/iron,
/area/shuttle/mining)
"k" = (
/obj/structure/shuttle/engine/propulsion,
/turf/open/floor/plating/airless,
/area/shuttle/mining)
"l" = (
/obj/structure/shuttle/engine/heater,
/obj/structure/window/reinforced{
	dir = 4
	},
/obj/structure/window/reinforced{
	dir = 1
	},
/obj/structure/window/reinforced{
	dir = 8
	},
/turf/open/floor/plating/airless,
/area/shuttle/mining)
"s" = (
/obj/structure/shuttle/engine/heater,
/obj/structure/window/reinforced{
	dir = 8
	},
/obj/structure/window/reinforced{
	dir = 1
	},
/obj/structure/window/reinforced{
	dir = 4
	},
/turf/open/floor/plating/airless,
/area/shuttle/mining)
"v" = (
/obj/structure/table/reinforced,
/obj/item/radio{
	name = "walkie-talkie";
	desc = "A basic handheld device that is connected to nearby walkie-talkies. For easy communication when far from eachother.";
	pixel_y = 5;
	pixel_x = -4
	},
/turf/open/floor/iron/dark/textured_large,
/area/shuttle/mining)
"A" = (
/obj/effect/turf_decal/arrows,
/obj/structure/fluff/broken_flooring{
	icon_state = "singular";
	dir = 4
	},
/turf/open/floor/iron,
/area/shuttle/mining)
"H" = (
/obj/structure/chair/comfy/shuttle{
	dir = 8
	},
/turf/open/floor/iron,
/area/shuttle/mining)
"N" = (
/turf/closed/wall/mineral/titanium/exterior,
/area/shuttle/mining)
"O" = (
/obj/item/shard{
	icon_state = "small"
	},
/obj/effect/decal/cleanable/glass,
/turf/open/floor/iron/dark/textured_large,
/area/shuttle/mining)
"P" = (
/obj/effect/turf_decal/siding/thinplating/dark{
	dir = 1
	},
/turf/open/floor/plating,
/area/shuttle/mining)
"Q" = (
/obj/structure/chair/comfy/shuttle{
	dir = 1
	},
/turf/open/floor/iron/dark/textured_large,
/area/shuttle/mining)
"R" = (
/obj/effect/turf_decal/siding/thinplating/dark{
	dir = 1
	},
/obj/structure/fluff/broken_flooring{
	icon_state = "singular";
	dir = 1
	},
/turf/open/floor/iron,
/area/shuttle/mining)

(1,1,1) = {"
N
N
b
a
b
s
k
"}
(2,1,1) = {"
b
c
O
g
f
i
N
"}
(3,1,1) = {"
b
d
Q
R
A
j
N
"}
(4,1,1) = {"
b
v
e
P
H
i
N
"}
(5,1,1) = {"
N
N
b
h
b
l
k
"}
