//MAP CONVERTED BY dmm2tgm.py THIS HEADER COMMENT PREVENTS RECONVERSION, DO NOT REMOVE
"at" = (
/obj/machinery/power/smes/shuttle/precharged{
	dir = 4
	},
/obj/structure/cable/yellow{
	icon_state = "0-8"
	},
/turf/open/floor/plating,
/area/ship/engineering)
"aU" = (
/obj/structure/cable{
	icon_state = "1-2"
	},
/obj/structure/cable{
	icon_state = "1-2"
	},
/turf/open/floor/iron/dark,
/area/ship/science)
"aY" = (
/obj/effect/turf_decal/industrial/warning{
	dir = 4
	},
/turf/open/floor/iron/dark,
/area/ship/hallway/central)
"bt" = (
/obj/machinery/atmospherics/pipe/manifold4w/supply/hidden/layer4,
/obj/machinery/atmospherics/pipe/manifold4w/scrubbers/hidden/layer2,
/turf/open/floor/iron/dark,
/area/ship/bridge)
"bT" = (
/obj/structure/chair/office{
	dir = 1
	},
/obj/structure/cable{
	icon_state = "1-2"
	},
/turf/open/floor/iron/dark,
/area/ship/medical)
"ca" = (
/obj/machinery/atmospherics/pipe/manifold/supply/hidden/layer4{
	dir = 4
	},
/obj/machinery/atmospherics/pipe/manifold/scrubbers/hidden/layer2{
	dir = 1
	},
/obj/structure/cable{
	icon_state = "4-8"
	},
/turf/open/floor/iron/dark,
/area/ship/bridge)
"cm" = (
/obj/machinery/atmospherics/pipe/simple/supply/hidden/layer4{
	dir = 4
	},
/obj/machinery/atmospherics/pipe/simple/scrubbers/hidden/layer2{
	dir = 4
	},
/obj/effect/turf_decal/industrial/warning/corner{
	dir = 8
	},
/obj/machinery/power/apc/auto_name/south,
/obj/structure/cable{
	icon_state = "0-8"
	},
/obj/structure/cable{
	icon_state = "4-8"
	},
/obj/machinery/light,
/turf/open/floor/iron/dark,
/area/ship/hallway/starboard)
"cZ" = (
/obj/machinery/atmospherics/components/unary/shuttle/heater{
	dir = 4
	},
/turf/open/floor/plating,
/area/ship/engineering)
"dc" = (
/obj/effect/turf_decal/industrial/warning,
/obj/structure/cable{
	icon_state = "1-2"
	},
/turf/open/floor/iron/dark,
/area/ship/medical)
"dM" = (
/obj/effect/turf_decal/industrial/warning{
	dir = 1
	},
/obj/structure/cable{
	icon_state = "1-2"
	},
/turf/open/floor/iron/dark,
/area/ship/bridge)
"dR" = (
/obj/machinery/atmospherics/components/unary/vent_pump/on/layer4{
	dir = 1
	},
/obj/effect/turf_decal/industrial/warning,
/turf/open/floor/iron/dark,
/area/ship/bridge)
"ex" = (
/obj/machinery/atmospherics/components/unary/outlet_injector/on/layer2{
	dir = 8
	},
/turf/open/floor/plating,
/area/ship/engineering)
"fz" = (
/obj/machinery/atmospherics/pipe/simple/supply/hidden/layer4{
	dir = 6
	},
/obj/structure/cable{
	icon_state = "4-8"
	},
/obj/machinery/atmospherics/pipe/manifold/scrubbers/hidden/layer2{
	dir = 8
	},
/turf/open/floor/iron/dark,
/area/ship/engineering)
"fV" = (
/obj/machinery/power/shuttle/engine/electric{
	dir = 4
	},
/obj/structure/cable/yellow{
	icon_state = "0-4"
	},
/turf/open/floor/plating,
/area/ship/external)
"gF" = (
/obj/structure/closet/crate/internals,
/obj/item/tank/internals/oxygen,
/obj/item/tank/internals/oxygen,
/obj/item/tank/internals/oxygen,
/obj/item/tank/internals/oxygen,
/obj/item/tank/internals/oxygen,
/obj/item/tank/internals/oxygen,
/obj/item/tank/internals/oxygen,
/obj/item/tank/internals/oxygen,
/obj/effect/turf_decal/industrial/warning{
	dir = 4
	},
/turf/open/floor/iron/dark,
/area/ship/hallway/central)
"hk" = (
/obj/structure/window/plasma/reinforced/plastitanium,
/obj/structure/grille,
/turf/open/floor/plating,
/area/ship/medical)
"ib" = (
/obj/machinery/suit_storage_unit/mining,
/obj/effect/turf_decal/industrial/warning{
	dir = 1
	},
/turf/open/floor/iron/dark,
/area/ship/hallway/central)
"iu" = (
/obj/machinery/power/terminal{
	dir = 8
	},
/obj/machinery/door/window/brigdoor{
	dir = 8
	},
/obj/machinery/atmospherics/pipe/simple/orange/visible{
	dir = 6
	},
/obj/structure/cable{
	icon_state = "0-2"
	},
/obj/machinery/airalarm/directional/north,
/turf/open/floor/plating/catwalk_floor{
	icon_state = "catwalk_above"
	},
/area/ship/engineering)
"iA" = (
/obj/machinery/atmospherics/pipe/simple/supply/hidden/layer4{
	dir = 4
	},
/obj/machinery/atmospherics/pipe/simple/scrubbers/hidden/layer2{
	dir = 4
	},
/obj/structure/cable{
	icon_state = "4-8"
	},
/turf/open/floor/iron/dark,
/area/ship/hallway/port)
"jd" = (
/obj/effect/turf_decal/industrial/warning,
/obj/machinery/light,
/obj/machinery/holopad/emergency/command,
/obj/item/radio/intercom/wideband{
	dir = 1;
	pixel_y = -33
	},
/turf/open/floor/iron/dark,
/area/ship/bridge)
"je" = (
/obj/structure/window/plasma/reinforced/plastitanium,
/obj/structure/grille,
/obj/machinery/atmospherics/pipe/simple/scrubbers/hidden/layer2{
	dir = 4
	},
/turf/open/floor/plating,
/area/ship/engineering)
"jT" = (
/obj/structure/table/reinforced,
/obj/item/stack/sheet/metal/twenty,
/obj/item/stack/sheet/glass/fifty,
/obj/item/areaeditor/shuttle,
/obj/effect/turf_decal/industrial/warning{
	dir = 1
	},
/turf/open/floor/iron/dark,
/area/ship/science)
"jV" = (
/obj/effect/turf_decal/industrial/warning,
/obj/structure/cable{
	icon_state = "1-2"
	},
/turf/open/floor/iron/dark,
/area/ship/bridge)
"kD" = (
/obj/machinery/atmospherics/components/unary/vent_pump/on/layer4,
/obj/effect/turf_decal/industrial/warning{
	dir = 1
	},
/obj/machinery/dna_scannernew,
/turf/open/floor/iron/dark,
/area/ship/medical)
"kM" = (
/obj/machinery/door/airlock/grunge,
/obj/machinery/atmospherics/pipe/simple/supply/hidden/layer4,
/obj/machinery/atmospherics/pipe/simple/scrubbers/hidden/layer2,
/turf/open/floor/iron/dark,
/area/ship/science)
"lu" = (
/obj/machinery/atmospherics/pipe/manifold/supply/hidden/layer4{
	dir = 4
	},
/obj/machinery/atmospherics/pipe/manifold/scrubbers/hidden/layer2,
/turf/open/floor/iron/dark,
/area/ship/bridge)
"lO" = (
/obj/machinery/atmospherics/components/unary/vent_pump/on/layer4{
	dir = 1
	},
/obj/effect/turf_decal/industrial/warning,
/turf/open/floor/iron/dark,
/area/ship/science)
"mw" = (
/obj/structure/window/plasma/reinforced/plastitanium,
/obj/structure/grille,
/turf/open/floor/plating,
/area/ship/hallway/central)
"mD" = (
/obj/machinery/atmospherics/pipe/simple/supply/hidden/layer4{
	dir = 4
	},
/obj/machinery/atmospherics/pipe/simple/scrubbers/hidden/layer2{
	dir = 4
	},
/obj/structure/cable{
	icon_state = "2-8"
	},
/turf/open/floor/iron/dark,
/area/ship/bridge)
"np" = (
/obj/machinery/atmospherics/pipe/simple/supply/hidden/layer4,
/obj/machinery/light{
	dir = 4
	},
/turf/open/floor/iron/dark,
/area/ship/science)
"nt" = (
/obj/effect/turf_decal/industrial/warning{
	dir = 4
	},
/obj/machinery/atmospherics/pipe/simple/supply/hidden/layer4,
/obj/machinery/atmospherics/pipe/manifold/scrubbers/hidden/layer2{
	dir = 8
	},
/turf/open/floor/iron/dark,
/area/ship/engineering)
"nR" = (
/obj/machinery/computer/crew{
	dir = 8
	},
/turf/open/floor/iron/dark,
/area/ship/bridge)
"ok" = (
/obj/machinery/atmospherics/pipe/simple/supply/hidden/layer4,
/obj/machinery/atmospherics/pipe/simple/scrubbers/hidden/layer2{
	dir = 5
	},
/obj/effect/turf_decal/industrial/warning{
	dir = 1
	},
/turf/open/floor/iron/dark,
/area/ship/science)
"on" = (
/obj/machinery/suit_storage_unit/captain,
/turf/open/floor/iron/dark,
/area/ship/bridge)
"oZ" = (
/turf/closed/wall/mineral/plastitanium/nodiagonal,
/area/ship/hallway/port)
"qs" = (
/obj/machinery/atmospherics/pipe/simple/supply/hidden/layer4{
	dir = 4
	},
/obj/machinery/atmospherics/pipe/simple/scrubbers/hidden/layer2{
	dir = 4
	},
/obj/effect/turf_decal/industrial/warning/corner{
	dir = 4
	},
/obj/structure/cable{
	icon_state = "4-8"
	},
/obj/machinery/light{
	dir = 1
	},
/turf/open/floor/iron/dark,
/area/ship/hallway/port)
"qz" = (
/obj/structure/cable/yellow{
	icon_state = "0-2"
	},
/obj/machinery/power/terminal{
	dir = 4
	},
/obj/machinery/atmospherics/components/unary/vent_pump/on/layer4{
	dir = 1
	},
/turf/open/floor/iron/dark,
/area/ship/engineering)
"qK" = (
/obj/machinery/atmospherics/pipe/simple/supply/hidden/layer4{
	dir = 4
	},
/obj/machinery/atmospherics/pipe/simple/scrubbers/hidden/layer2{
	dir = 4
	},
/obj/effect/turf_decal/industrial/warning,
/obj/structure/cable{
	icon_state = "4-8"
	},
/turf/open/floor/iron/dark,
/area/ship/hallway/starboard)
"ra" = (
/obj/machinery/power/port_gen/pacman/uranium,
/obj/structure/cable/yellow,
/obj/item/stack/sheet/mineral/uranium/twenty,
/turf/open/floor/plating/catwalk_floor{
	icon_state = "catwalk_above"
	},
/area/ship/engineering)
"rg" = (
/obj/machinery/atmospherics/pipe/simple/supply/hidden/layer4,
/obj/effect/turf_decal/industrial/warning{
	dir = 4
	},
/obj/machinery/light{
	dir = 4
	},
/obj/machinery/atmospherics/pipe/simple/scrubbers/hidden/layer2,
/turf/open/floor/iron/dark,
/area/ship/engineering)
"rA" = (
/obj/structure/table/glass,
/obj/item/gun/energy/beam_rifle,
/obj/machinery/cell_charger,
/obj/item/firing_pin,
/obj/effect/turf_decal/industrial/warning{
	dir = 8
	},
/obj/machinery/light{
	dir = 8
	},
/obj/item/firing_pin,
/obj/item/firing_pin,
/turf/open/floor/iron/dark,
/area/ship/bridge)
"ti" = (
/obj/item/reagent_containers/food/snacks/canned/beans{
	pixel_x = -5;
	pixel_y = 3
	},
/obj/item/reagent_containers/food/snacks/canned/beans{
	pixel_x = 2;
	pixel_y = 3
	},
/obj/item/reagent_containers/food/snacks/canned/beans{
	pixel_x = -2
	},
/obj/item/reagent_containers/food/drinks/waterbottle/large{
	pixel_x = 5
	},
/obj/item/reagent_containers/food/drinks/waterbottle/large{
	pixel_x = 1;
	pixel_y = -3
	},
/obj/item/reagent_containers/food/drinks/waterbottle/large{
	pixel_x = 8;
	pixel_y = -3
	},
/obj/structure/closet/crate{
	name = "food crate"
	},
/obj/item/storage/cans/sixbeer,
/obj/item/reagent_containers/food/snacks/rationpack,
/obj/item/reagent_containers/food/snacks/rationpack,
/obj/item/reagent_containers/food/snacks/rationpack,
/obj/item/reagent_containers/food/snacks/rationpack,
/obj/item/reagent_containers/food/snacks/rationpack,
/obj/item/reagent_containers/food/snacks/rationpack,
/obj/effect/turf_decal/industrial/warning,
/turf/open/floor/iron/dark,
/area/ship/hallway/central)
"tS" = (
/turf/closed/wall/mineral/plastitanium/nodiagonal,
/area/ship/hallway/central)
"tX" = (
/obj/structure/fans/tiny,
/obj/machinery/door/airlock/hatch{
	name = "external access hatch"
	},
/turf/open/floor/plating,
/area/ship/hallway/port)
"vr" = (
/obj/structure/closet/crate,
/obj/item/pickaxe/drill,
/obj/item/pickaxe/drill,
/obj/item/pickaxe/drill,
/obj/item/pickaxe/drill,
/obj/item/t_scanner/adv_mining_scanner,
/obj/item/t_scanner/adv_mining_scanner,
/obj/item/t_scanner/adv_mining_scanner,
/obj/item/t_scanner/adv_mining_scanner,
/obj/item/storage/bag/ore,
/obj/item/storage/bag/ore,
/obj/item/storage/bag/ore,
/obj/item/storage/bag/ore,
/obj/effect/turf_decal/industrial/warning{
	dir = 4
	},
/obj/machinery/power/apc/auto_name/north,
/obj/structure/cable{
	icon_state = "0-2"
	},
/turf/open/floor/iron/dark,
/area/ship/hallway/central)
"wF" = (
/obj/machinery/autolathe,
/turf/open/floor/iron/dark,
/area/ship/science)
"wT" = (
/obj/effect/turf_decal/industrial/warning{
	dir = 1
	},
/obj/structure/cable{
	icon_state = "1-2"
	},
/turf/open/floor/iron/dark,
/area/ship/science)
"wZ" = (
/obj/machinery/atmospherics/pipe/simple/supply/hidden/layer4{
	dir = 4
	},
/obj/machinery/atmospherics/pipe/simple/scrubbers/hidden/layer2{
	dir = 4
	},
/obj/structure/cable{
	icon_state = "4-8"
	},
/turf/open/floor/iron/dark,
/area/ship/hallway/central)
"xS" = (
/turf/open/floor/plating,
/area/ship/hallway/central)
"yh" = (
/obj/machinery/atmospherics/pipe/simple/supply/hidden/layer4{
	dir = 4
	},
/obj/machinery/atmospherics/pipe/simple/scrubbers/hidden/layer2{
	dir = 4
	},
/obj/structure/cable{
	icon_state = "4-8"
	},
/obj/machinery/airalarm/directional/north,
/turf/open/floor/iron/dark,
/area/ship/hallway/central)
"yF" = (
/obj/structure/cable{
	icon_state = "4-8"
	},
/obj/machinery/atmospherics/pipe/simple/scrubbers/hidden/layer2{
	dir = 5
	},
/obj/machinery/atmospherics/pipe/manifold/supply/hidden/layer4{
	dir = 8
	},
/turf/open/floor/iron/dark,
/area/ship/engineering)
"zJ" = (
/obj/machinery/atmospherics/components/unary/vent_scrubber/on/layer2{
	dir = 8
	},
/turf/open/floor/iron/dark,
/area/ship/bridge)
"Ai" = (
/obj/machinery/atmospherics/components/unary/vent_pump/on/layer4{
	dir = 1
	},
/obj/structure/closet/crate/engineering,
/obj/item/storage/belt/utility/full/engi,
/obj/item/storage/belt/utility/full/engi,
/obj/item/clothing/gloves/color/yellow,
/obj/item/clothing/gloves/color/yellow,
/obj/effect/turf_decal/industrial/warning,
/turf/open/floor/iron/dark,
/area/ship/hallway/central)
"At" = (
/obj/effect/turf_decal/industrial/warning,
/obj/machinery/power/apc/auto_name/south,
/obj/structure/cable,
/obj/structure/table/optable,
/turf/open/floor/iron/dark,
/area/ship/science)
"BO" = (
/obj/effect/turf_decal/industrial/warning{
	dir = 1
	},
/obj/machinery/power/apc/auto_name/north,
/obj/structure/cable{
	icon_state = "0-2"
	},
/obj/machinery/light{
	dir = 1
	},
/turf/open/floor/iron/dark,
/area/ship/bridge)
"BQ" = (
/obj/machinery/atmospherics/pipe/simple/supply/hidden/layer4,
/obj/machinery/computer/cryopod{
	pixel_x = 32
	},
/obj/machinery/light{
	dir = 4
	},
/turf/open/floor/iron/dark,
/area/ship/medical)
"BS" = (
/obj/machinery/power/terminal{
	dir = 8
	},
/obj/machinery/door/window/brigdoor{
	dir = 8
	},
/obj/machinery/atmospherics/pipe/simple/orange/visible,
/obj/structure/cable{
	icon_state = "1-2"
	},
/obj/structure/cable,
/obj/structure/cable{
	icon_state = "2-4"
	},
/turf/open/floor/plating/catwalk_floor{
	icon_state = "catwalk_above"
	},
/area/ship/engineering)
"Ca" = (
/obj/machinery/door/airlock/grunge,
/obj/structure/cable{
	icon_state = "1-2"
	},
/turf/open/floor/iron/dark,
/area/ship/medical)
"CI" = (
/obj/machinery/atmospherics/pipe/manifold/supply/hidden/layer4{
	dir = 8
	},
/obj/machinery/atmospherics/pipe/manifold/scrubbers/hidden/layer2{
	dir = 8
	},
/obj/structure/cable{
	icon_state = "1-2"
	},
/obj/structure/cable{
	icon_state = "1-4"
	},
/turf/open/floor/iron/dark,
/area/ship/hallway/central)
"Dv" = (
/obj/structure/window/plasma/reinforced/plastitanium,
/obj/structure/grille,
/turf/open/floor/plating,
/area/ship/bridge)
"DE" = (
/obj/structure/fans/tiny,
/obj/docking_port/mobile{
	can_move_docking_ports = 1;
	dir = 2;
	launch_status = 0;
	name = "mining ship";
	port_direction = 8;
	preferred_direction = 4
	},
/obj/machinery/door/airlock/hatch{
	name = "external access hatch"
	},
/turf/open/floor/plating,
/area/ship/hallway/starboard)
"Ec" = (
/turf/open/floor/iron/dark,
/area/ship/hallway/central)
"Eh" = (
/obj/structure/window/plasma/reinforced/plastitanium,
/obj/structure/grille,
/turf/open/floor/plating,
/area/ship/hallway/starboard)
"Ej" = (
/obj/machinery/power/terminal{
	dir = 8
	},
/obj/machinery/door/window/brigdoor{
	dir = 8
	},
/obj/structure/cable,
/turf/open/floor/plating/catwalk_floor{
	icon_state = "catwalk_above"
	},
/area/ship/engineering)
"ES" = (
/turf/closed/wall/mineral/plastitanium/nodiagonal,
/area/ship/medical)
"Fa" = (
/turf/closed/wall/mineral/plastitanium/nodiagonal,
/area/ship/bridge)
"Gf" = (
/obj/structure/window/plasma/reinforced/plastitanium,
/obj/structure/grille,
/turf/open/floor/plating,
/area/ship/hallway/port)
"Gj" = (
/obj/machinery/atmospherics/pipe/simple/supply/hidden/layer4,
/obj/machinery/atmospherics/pipe/simple/scrubbers/hidden/layer2,
/obj/structure/cable{
	icon_state = "1-2"
	},
/turf/open/floor/iron/dark,
/area/ship/hallway/central)
"GC" = (
/obj/machinery/atmospherics/pipe/simple/supply/hidden/layer4,
/obj/machinery/atmospherics/pipe/simple/scrubbers/hidden/layer2,
/obj/effect/turf_decal/industrial/warning,
/turf/open/floor/iron/dark,
/area/ship/bridge)
"GK" = (
/obj/machinery/atmospherics/pipe/simple/supply/hidden/layer4,
/obj/machinery/atmospherics/pipe/simple/scrubbers/hidden/layer2{
	dir = 6
	},
/obj/effect/turf_decal/industrial/warning,
/turf/open/floor/iron/dark,
/area/ship/medical)
"Hh" = (
/obj/machinery/atmospherics/pipe/manifold/supply/hidden/layer4,
/obj/machinery/atmospherics/pipe/simple/scrubbers/hidden/layer2{
	dir = 4
	},
/obj/structure/cable{
	icon_state = "4-8"
	},
/obj/machinery/light,
/turf/open/floor/iron/dark,
/area/ship/engineering)
"Hl" = (
/obj/machinery/atmospherics/components/unary/vent_pump/on/layer4,
/obj/effect/turf_decal/industrial/warning{
	dir = 1
	},
/turf/open/floor/iron/dark,
/area/ship/bridge)
"Hz" = (
/obj/machinery/atmospherics/components/unary/vent_pump/on/layer4,
/obj/structure/closet/crate/medical,
/obj/item/storage/backpack/duffelbag/med/surgery,
/obj/item/storage/firstaid/tactical,
/obj/item/storage/firstaid/medical,
/obj/effect/turf_decal/industrial/warning{
	dir = 1
	},
/obj/item/storage/pill_bottle/stimulant,
/obj/item/storage/pill_bottle/stimulant,
/turf/open/floor/iron/dark,
/area/ship/hallway/central)
"IK" = (
/obj/machinery/atmospherics/pipe/manifold4w/supply/hidden/layer4,
/obj/machinery/atmospherics/pipe/manifold4w/scrubbers/hidden/layer2,
/obj/structure/cable{
	icon_state = "4-8"
	},
/turf/open/floor/iron/dark,
/area/ship/bridge)
"IP" = (
/turf/closed/wall/mineral/plastitanium/interior,
/area/ship/medical)
"IT" = (
/obj/machinery/suit_storage_unit/mining,
/obj/effect/turf_decal/industrial/warning,
/turf/open/floor/iron/dark,
/area/ship/hallway/central)
"Jp" = (
/obj/effect/turf_decal/industrial/warning{
	dir = 4
	},
/obj/machinery/light{
	dir = 4
	},
/turf/open/floor/iron/dark,
/area/ship/hallway/central)
"Js" = (
/obj/machinery/power/shuttle/engine/fueled/plasma{
	dir = 4
	},
/turf/open/floor/plating,
/area/ship/external)
"JI" = (
/obj/machinery/atmospherics/pipe/simple/supply/hidden/layer4{
	dir = 4
	},
/obj/machinery/atmospherics/pipe/simple/scrubbers/hidden/layer2{
	dir = 4
	},
/obj/effect/turf_decal/industrial/warning{
	dir = 4
	},
/obj/structure/cable{
	icon_state = "4-8"
	},
/turf/open/floor/iron/dark,
/area/ship/hallway/central)
"LP" = (
/obj/machinery/atmospherics/pipe/simple/supply/hidden/layer4{
	dir = 4
	},
/obj/machinery/atmospherics/pipe/simple/scrubbers/hidden/layer2{
	dir = 4
	},
/obj/effect/turf_decal/industrial/warning/corner{
	dir = 1
	},
/obj/machinery/power/apc/auto_name/north,
/obj/structure/cable{
	icon_state = "0-8"
	},
/obj/structure/cable{
	icon_state = "4-8"
	},
/obj/machinery/light{
	dir = 1
	},
/turf/open/floor/iron/dark,
/area/ship/hallway/port)
"Mf" = (
/obj/machinery/atmospherics/pipe/simple/orange/visible,
/obj/structure/cable{
	icon_state = "1-2"
	},
/turf/open/floor/plating/catwalk_floor{
	icon_state = "catwalk_above"
	},
/area/ship/engineering)
"Mu" = (
/turf/closed/wall/mineral/plastitanium/nodiagonal,
/area/ship/hallway/starboard)
"Nb" = (
/obj/machinery/atmospherics/pipe/manifold/supply/hidden/layer4{
	dir = 4
	},
/obj/machinery/atmospherics/pipe/manifold/scrubbers/hidden/layer2{
	dir = 1
	},
/obj/structure/cable{
	icon_state = "4-8"
	},
/obj/structure/cable{
	icon_state = "2-8"
	},
/turf/open/floor/iron/dark,
/area/ship/hallway/central)
"Nm" = (
/obj/structure/window/reinforced{
	dir = 8
	},
/obj/machinery/atmospherics/pipe/manifold/orange/visible{
	dir = 4
	},
/obj/structure/cable{
	icon_state = "1-2"
	},
/turf/open/floor/plating/catwalk_floor{
	icon_state = "catwalk_above"
	},
/area/ship/engineering)
"NB" = (
/obj/structure/cable,
/obj/machinery/power/smes/engineering{
	charge = 1e+006;
	dir = 8
	},
/turf/open/floor/iron/dark,
/area/ship/engineering)
"NR" = (
/obj/machinery/atmospherics/pipe/simple/supply/hidden/layer4{
	dir = 4
	},
/obj/machinery/atmospherics/pipe/simple/scrubbers/hidden/layer2{
	dir = 4
	},
/obj/structure/cable{
	icon_state = "4-8"
	},
/turf/open/floor/iron/dark,
/area/ship/hallway/starboard)
"Ok" = (
/obj/machinery/atmospherics/pipe/simple/orange/visible{
	dir = 9
	},
/obj/structure/window/reinforced{
	dir = 8
	},
/obj/structure/cable{
	icon_state = "1-2"
	},
/turf/open/floor/plating/catwalk_floor{
	icon_state = "catwalk_above"
	},
/area/ship/engineering)
"Oo" = (
/obj/structure/lattice,
/turf/template_noop,
/area/ship/external)
"Or" = (
/obj/machinery/computer/helm{
	dir = 8
	},
/turf/open/floor/iron/dark,
/area/ship/bridge)
"OH" = (
/obj/machinery/door/airlock/grunge,
/obj/machinery/atmospherics/pipe/simple/supply/hidden/layer4{
	dir = 4
	},
/obj/machinery/atmospherics/pipe/simple/scrubbers/hidden/layer2{
	dir = 4
	},
/obj/structure/cable{
	icon_state = "4-8"
	},
/turf/open/floor/iron/dark,
/area/ship/engineering)
"OM" = (
/turf/template_noop,
/area/template_noop)
"Pw" = (
/obj/structure/window/plasma/reinforced/plastitanium,
/obj/structure/grille,
/turf/open/floor/plating,
/area/ship/science)
"Py" = (
/obj/machinery/door/airlock/grunge,
/obj/structure/cable{
	icon_state = "1-2"
	},
/turf/open/floor/iron/dark,
/area/ship/science)
"PF" = (
/obj/structure/closet/secure_closet/captains,
/obj/item/gun/energy/laser/captain,
/turf/open/floor/iron/dark,
/area/ship/bridge)
"PJ" = (
/obj/machinery/atmospherics/components/unary/tank/toxins,
/turf/open/floor/iron/dark,
/area/ship/engineering)
"Qb" = (
/obj/machinery/atmospherics/pipe/simple/supply/hidden/layer4,
/obj/machinery/atmospherics/pipe/simple/scrubbers/hidden/layer2,
/obj/effect/turf_decal/industrial/warning{
	dir = 1
	},
/turf/open/floor/iron/dark,
/area/ship/bridge)
"Qu" = (
/obj/effect/turf_decal/industrial/warning{
	dir = 4
	},
/obj/structure/cable{
	icon_state = "1-2"
	},
/turf/open/floor/iron/dark,
/area/ship/hallway/central)
"QU" = (
/obj/machinery/atmospherics/pipe/simple/supply/hidden/layer4{
	dir = 4
	},
/obj/machinery/atmospherics/pipe/simple/scrubbers/hidden/layer2{
	dir = 4
	},
/obj/structure/cable{
	icon_state = "4-8"
	},
/obj/structure/cable{
	icon_state = "1-8"
	},
/turf/open/floor/iron/dark,
/area/ship/bridge)
"Rg" = (
/obj/machinery/door/airlock/grunge,
/obj/machinery/atmospherics/pipe/simple/supply/hidden/layer4{
	dir = 4
	},
/obj/machinery/atmospherics/pipe/simple/scrubbers/hidden/layer2{
	dir = 4
	},
/obj/structure/cable{
	icon_state = "4-8"
	},
/turf/open/floor/iron/dark,
/area/ship/bridge)
"Rn" = (
/obj/machinery/atmospherics/components/unary/vent_scrubber/on/layer2,
/obj/machinery/atmospherics/pipe/simple/orange/hidden{
	dir = 9
	},
/turf/open/floor/iron/dark,
/area/ship/engineering)
"RA" = (
/obj/structure/reagent_dispensers/fueltank,
/obj/effect/turf_decal/industrial/warning{
	dir = 1
	},
/turf/open/floor/iron/dark,
/area/ship/hallway/central)
"RR" = (
/obj/machinery/atmospherics/pipe/manifold/supply/hidden/layer4{
	dir = 8
	},
/obj/machinery/atmospherics/pipe/manifold/scrubbers/hidden/layer2{
	dir = 8
	},
/obj/structure/cable{
	icon_state = "1-2"
	},
/obj/structure/cable{
	icon_state = "2-4"
	},
/turf/open/floor/iron/dark,
/area/ship/hallway/central)
"RV" = (
/obj/machinery/atmospherics/components/unary/vent_scrubber/on/layer2{
	dir = 8
	},
/obj/effect/turf_decal/industrial/warning,
/obj/machinery/cryopod,
/turf/open/floor/iron/dark,
/area/ship/medical)
"Sj" = (
/obj/machinery/atmospherics/components/unary/vent_scrubber/on/layer2{
	dir = 8
	},
/obj/effect/turf_decal/industrial/warning{
	dir = 4
	},
/obj/structure/cable{
	icon_state = "1-8"
	},
/obj/machinery/light{
	dir = 4
	},
/turf/open/floor/iron/dark,
/area/ship/hallway/central)
"ST" = (
/obj/structure/cable{
	icon_state = "2-8"
	},
/obj/machinery/atmospherics/pipe/simple/supply/hidden/layer4{
	dir = 4
	},
/obj/machinery/atmospherics/pipe/simple/scrubbers/hidden/layer2{
	dir = 4
	},
/obj/machinery/power/apc/auto_name/north,
/obj/structure/cable{
	icon_state = "0-2"
	},
/obj/structure/cable{
	icon_state = "2-4"
	},
/obj/machinery/light{
	dir = 1
	},
/turf/open/floor/iron/dark,
/area/ship/engineering)
"SX" = (
/obj/machinery/door/airlock/grunge,
/obj/machinery/atmospherics/pipe/simple/supply/hidden/layer4{
	dir = 4
	},
/obj/machinery/atmospherics/pipe/simple/scrubbers/hidden/layer2{
	dir = 4
	},
/obj/structure/cable{
	icon_state = "4-8"
	},
/turf/open/floor/iron/dark,
/area/ship/hallway/central)
"Tk" = (
/obj/machinery/atmospherics/components/unary/vent_scrubber/on/layer2{
	dir = 8
	},
/obj/structure/cable{
	icon_state = "1-8"
	},
/turf/open/floor/iron/dark,
/area/ship/bridge)
"Tp" = (
/turf/closed/wall/mineral/plastitanium/nodiagonal,
/area/ship/engineering)
"Tw" = (
/obj/machinery/light{
	dir = 8
	},
/turf/open/floor/iron/dark,
/area/ship/hallway/central)
"TU" = (
/turf/closed/wall/mineral/plastitanium/nodiagonal,
/area/ship/science)
"Us" = (
/obj/machinery/atmospherics/components/unary/vent_scrubber/on/layer2{
	dir = 8
	},
/obj/effect/turf_decal/industrial/warning{
	dir = 1
	},
/obj/machinery/airalarm/directional/north,
/turf/open/floor/iron/dark,
/area/ship/science)
"Ux" = (
/obj/machinery/power/terminal{
	dir = 8
	},
/obj/machinery/door/window/brigdoor{
	dir = 8
	},
/obj/structure/cable{
	icon_state = "1-2"
	},
/obj/structure/cable{
	icon_state = "0-2"
	},
/obj/structure/cable{
	icon_state = "1-4"
	},
/turf/open/floor/plating/catwalk_floor{
	icon_state = "catwalk_above"
	},
/area/ship/engineering)
"VG" = (
/obj/machinery/door/airlock/grunge,
/obj/machinery/atmospherics/pipe/simple/supply/hidden/layer4,
/obj/machinery/atmospherics/pipe/simple/scrubbers/hidden/layer2,
/turf/open/floor/iron/dark,
/area/ship/medical)
"VV" = (
/obj/machinery/atmospherics/components/unary/vent_scrubber/on/layer2{
	dir = 8
	},
/obj/effect/turf_decal/industrial/warning{
	dir = 4
	},
/turf/open/floor/iron/dark,
/area/ship/hallway/central)
"Wx" = (
/obj/machinery/atmospherics/pipe/simple/supply/hidden/layer4{
	dir = 4
	},
/obj/machinery/atmospherics/pipe/simple/scrubbers/hidden/layer2{
	dir = 4
	},
/obj/effect/turf_decal/industrial/warning{
	dir = 1
	},
/obj/structure/cable{
	icon_state = "4-8"
	},
/turf/open/floor/iron/dark,
/area/ship/hallway/port)
"WW" = (
/obj/machinery/atmospherics/pipe/manifold/supply/hidden/layer4{
	dir = 4
	},
/obj/machinery/atmospherics/pipe/manifold/scrubbers/hidden/layer2,
/obj/structure/cable{
	icon_state = "1-8"
	},
/turf/open/floor/iron/dark,
/area/ship/hallway/central)
"WZ" = (
/obj/machinery/atmospherics/pipe/simple/supply/hidden/layer4{
	dir = 4
	},
/obj/machinery/atmospherics/pipe/simple/scrubbers/hidden/layer2{
	dir = 4
	},
/obj/effect/turf_decal/industrial/warning/corner,
/obj/structure/cable{
	icon_state = "4-8"
	},
/obj/machinery/light,
/turf/open/floor/iron/dark,
/area/ship/hallway/starboard)
"Xc" = (
/obj/machinery/atmospherics/components/unary/tank/air{
	piping_layer = 4
	},
/turf/open/floor/iron/dark,
/area/ship/engineering)
"Xo" = (
/obj/machinery/airalarm/directional/west,
/obj/machinery/shower{
	dir = 4
	},
/turf/open/floor/iron/dark,
/area/ship/medical)
"XP" = (
/obj/effect/turf_decal/industrial/warning{
	dir = 1
	},
/obj/machinery/power/apc/auto_name/north,
/obj/machinery/computer/scan_consolenew,
/obj/structure/cable{
	icon_state = "0-2"
	},
/turf/open/floor/iron/dark,
/area/ship/medical)
"Yn" = (
/obj/structure/table/glass,
/obj/item/gun/energy/ionrifle,
/obj/machinery/recharger,
/obj/effect/turf_decal/industrial/warning{
	dir = 8
	},
/obj/machinery/airalarm/directional/north,
/obj/machinery/light{
	dir = 8
	},
/turf/open/floor/iron/dark,
/area/ship/bridge)
"Yq" = (
/obj/machinery/atmospherics/pipe/simple/supply/hidden/layer4{
	dir = 4
	},
/obj/machinery/atmospherics/pipe/simple/scrubbers/hidden/layer2{
	dir = 4
	},
/obj/effect/turf_decal/industrial/warning{
	dir = 8
	},
/obj/structure/cable{
	icon_state = "4-8"
	},
/turf/open/floor/iron/dark,
/area/ship/bridge)
"YA" = (
/obj/effect/turf_decal/industrial/warning,
/obj/structure/table/reinforced,
/obj/item/storage/box/monkeycubes,
/obj/item/storage/box/monkeycubes,
/obj/item/storage/pill_bottle/mutadone,
/obj/item/storage/pill_bottle/mannitol,
/turf/open/floor/iron/dark,
/area/ship/medical)

(1,1,1) = {"
OM
OM
Tp
fV
fV
Js
Tp
Tp
Js
fV
fV
Tp
OM
OM
"}
(2,1,1) = {"
OM
OM
Tp
at
at
cZ
Tp
Tp
cZ
at
at
Tp
OM
OM
"}
(3,1,1) = {"
OM
Tp
Tp
iu
BS
Nm
Mf
Mf
Ok
Ux
Ej
Tp
Tp
OM
"}
(4,1,1) = {"
OM
Tp
PJ
Rn
fz
rg
nt
nt
rg
yF
qz
ra
Tp
OM
"}
(5,1,1) = {"
OM
Tp
Tp
Xc
Hh
Tp
je
je
Tp
ST
NB
Tp
Tp
OM
"}
(6,1,1) = {"
OM
OM
Tp
Tp
OH
Tp
ex
ex
Tp
OH
Tp
Tp
OM
OM
"}
(7,1,1) = {"
OM
OM
OM
oZ
iA
Gf
OM
OM
Eh
NR
Mu
OM
OM
OM
"}
(8,1,1) = {"
OM
OM
OM
oZ
qs
Gf
Oo
Oo
Eh
WZ
Mu
OM
OM
OM
"}
(9,1,1) = {"
OM
OM
OM
tX
Wx
Gf
OM
OM
Eh
qK
DE
OM
OM
OM
"}
(10,1,1) = {"
OM
OM
OM
oZ
LP
Gf
OM
OM
Eh
cm
Mu
OM
OM
OM
"}
(11,1,1) = {"
OM
OM
OM
oZ
iA
Gf
Oo
Oo
Eh
NR
Mu
OM
OM
OM
"}
(12,1,1) = {"
OM
OM
OM
oZ
iA
Gf
OM
OM
Eh
NR
Mu
OM
OM
OM
"}
(13,1,1) = {"
OM
OM
tS
tS
SX
tS
xS
xS
tS
SX
tS
tS
OM
OM
"}
(14,1,1) = {"
OM
OM
mw
ib
wZ
tS
mw
mw
tS
yh
IT
mw
OM
OM
"}
(15,1,1) = {"
OM
OM
mw
ib
wZ
Tw
Ec
Ec
Tw
wZ
IT
mw
OM
OM
"}
(16,1,1) = {"
OM
OM
tS
RA
wZ
Ec
Ec
Ec
Ec
wZ
ti
tS
OM
OM
"}
(17,1,1) = {"
OM
tS
tS
Hz
Nb
Gj
CI
RR
Gj
WW
Ai
tS
tS
OM
"}
(18,1,1) = {"
OM
tS
vr
Qu
Sj
aY
JI
JI
aY
VV
Jp
gF
tS
OM
"}
(19,1,1) = {"
OM
ES
ES
ES
ES
Fa
Rg
Rg
Fa
TU
TU
TU
TU
OM
"}
(20,1,1) = {"
ES
ES
Xo
YA
IP
Yn
Yq
Yq
rA
TU
jT
wF
TU
TU
"}
(21,1,1) = {"
ES
XP
bT
dc
Ca
dM
QU
mD
jV
Py
wT
aU
At
TU
"}
(22,1,1) = {"
hk
kD
BQ
GK
VG
Qb
IK
bt
GC
kM
ok
np
lO
Pw
"}
(23,1,1) = {"
ES
IP
ES
RV
ES
Hl
ca
lu
dR
TU
Us
TU
TU
TU
"}
(24,1,1) = {"
OM
OM
ES
hk
ES
BO
Tk
zJ
jd
TU
Pw
TU
OM
OM
"}
(25,1,1) = {"
OM
OM
OM
OM
ES
on
Or
nR
PF
TU
OM
OM
OM
OM
"}
(26,1,1) = {"
OM
OM
OM
OM
ES
Dv
Dv
Dv
Dv
TU
OM
OM
OM
OM
"}
(27,1,1) = {"
OM
OM
OM
OM
OM
OM
Dv
Dv
OM
OM
OM
OM
OM
OM
"}
