//MAP CONVERTED BY dmm2tgm.py THIS HEADER COMMENT PREVENTS RECONVERSION, DO NOT REMOVE
"bj" = (
/obj/machinery/hydroponics/constructable,
/obj/structure/cable{
	icon_state = "1-4"
	},
/turf/open/floor/grass/fairy,
/area/ship/crew/hydroponics)
"bn" = (
/obj/effect/decal/cleanable/dirt/dust,
/obj/structure/flora/ausbushes/brflowers,
/turf/open/floor/grass,
/area/ship/bridge)
"bt" = (
/obj/machinery/power/shuttle/engine/electric{
	dir = 1
	},
/obj/structure/cable,
/turf/open/floor/plating,
/area/ship/external)
"bL" = (
/obj/structure/cable{
	icon_state = "2-4"
	},
/obj/effect/decal/cleanable/dirt/dust,
/turf/open/floor/wood{
	icon_state = "wood-broken2"
	},
/area/ship/crew/hydroponics)
"bP" = (
/obj/effect/decal/cleanable/dirt/dust,
/turf/open/floor/wood{
	icon_state = "wood-broken5"
	},
/area/ship/bridge)
"cC" = (
/obj/structure/cable{
	icon_state = "1-2"
	},
/obj/structure/flora/ausbushes/ppflowers,
/turf/open/floor/grass,
/area/ship/bridge)
"dl" = (
/obj/effect/decal/cleanable/dirt/dust,
/obj/structure/flora/ausbushes/ywflowers/hell,
/turf/open/floor/grass/fairy,
/area/ship/crew/hydroponics)
"dt" = (
/obj/machinery/hydroponics/constructable,
/obj/effect/decal/cleanable/dirt/dust,
/turf/open/floor/grass,
/area/ship/crew/hydroponics)
"eq" = (
/obj/effect/decal/cleanable/dirt/dust,
/obj/effect/decal/cleanable/dirt/dust,
/obj/structure/cable{
	icon_state = "2-8"
	},
/turf/open/floor/wood,
/area/ship/bridge)
"eJ" = (
/obj/effect/decal/cleanable/dirt/dust,
/obj/structure/flora/junglebush/c,
/turf/open/floor/grass,
/area/ship/crew/hydroponics)
"eZ" = (
/obj/effect/decal/cleanable/dirt/dust,
/obj/structure/flora/junglebush/c,
/turf/open/floor/grass,
/area/ship/bridge)
"fk" = (
/obj/structure/flora/ausbushes/ppflowers,
/turf/open/floor/grass,
/area/ship/crew/hydroponics)
"fA" = (
/obj/structure/flora/ausbushes/sparsegrass,
/turf/open/floor/grass,
/area/ship/bridge)
"gN" = (
/obj/structure/flora/ausbushes/ywflowers,
/turf/open/floor/grass,
/area/ship/crew/hydroponics)
"ht" = (
/obj/structure/cable{
	icon_state = "1-2"
	},
/obj/structure/flora/ausbushes/ppflowers,
/turf/open/floor/grass,
/area/ship/crew/hydroponics)
"hG" = (
/obj/structure/cable{
	icon_state = "2-8"
	},
/obj/structure/cable{
	icon_state = "2-4"
	},
/obj/effect/decal/cleanable/dirt/dust,
/turf/open/floor/grass,
/area/ship/bridge)
"hQ" = (
/obj/effect/decal/cleanable/dirt/dust,
/obj/structure/flora/ausbushes/lavendergrass,
/turf/open/floor/grass/fairy,
/area/ship/crew/hydroponics)
"jl" = (
/obj/structure/table/glass{
	layer = 2.6
	},
/obj/machinery/reagentgrinder,
/obj/machinery/light/broken{
	dir = 8
	},
/turf/open/floor/wood,
/area/ship/crew/hydroponics)
"jQ" = (
/obj/effect/spawner/structure/window/reinforced,
/obj/machinery/door/poddoor/shutters{
	id = "botnbridge"
	},
/obj/docking_port/mobile{
	launch_status = 0;
	port_direction = 2
	},
/turf/open/floor/plating,
/area/ship/bridge)
"kd" = (
/obj/effect/spawner/structure/window/reinforced,
/obj/machinery/door/poddoor/shutters{
	id = "botnbridge"
	},
/turf/open/floor/plating,
/area/ship/bridge)
"kR" = (
/obj/structure/flora/ausbushes/brflowers,
/turf/open/floor/grass,
/area/ship/crew/hydroponics)
"kW" = (
/obj/structure/cable{
	icon_state = "2-8"
	},
/obj/effect/decal/cleanable/dirt/dust,
/turf/open/floor/wood,
/area/ship/bridge)
"le" = (
/obj/machinery/power/terminal,
/obj/structure/cable/yellow{
	icon_state = "0-2"
	},
/obj/machinery/power/port_gen/pacman{
	anchored = 1
	},
/turf/open/floor/grass/fairy,
/area/ship/crew/hydroponics)
"lF" = (
/obj/structure/cable{
	icon_state = "2-4"
	},
/obj/effect/decal/cleanable/dirt/dust,
/obj/structure/flora/ausbushes/ywflowers,
/turf/open/floor/grass,
/area/ship/crew/hydroponics)
"mm" = (
/turf/open/floor/wood{
	icon_state = "wood-broken4"
	},
/area/ship/bridge)
"mL" = (
/obj/structure/cable{
	icon_state = "1-8"
	},
/obj/structure/flora/ausbushes/sparsegrass,
/turf/open/floor/grass,
/area/ship/crew/hydroponics)
"oz" = (
/obj/machinery/light/dim{
	dir = 1
	},
/obj/machinery/suit_storage_unit/standard_unit,
/turf/open/floor/wood,
/area/ship/bridge)
"oB" = (
/obj/structure/table/glass{
	layer = 2.6
	},
/obj/item/reagent_containers/glass/bucket{
	pixel_x = 8
	},
/obj/item/reagent_containers/glass/bucket{
	pixel_x = -8
	},
/obj/item/reagent_containers/glass/bucket,
/turf/open/floor/wood,
/area/ship/crew/hydroponics)
"pb" = (
/obj/effect/decal/cleanable/dirt/dust,
/turf/open/floor/wood{
	icon_state = "wood-broken4"
	},
/area/ship/crew/hydroponics)
"pu" = (
/obj/effect/decal/cleanable/dirt/dust,
/obj/structure/flora/ausbushes/sparsegrass,
/turf/open/floor/grass,
/area/ship/crew/hydroponics)
"pZ" = (
/obj/machinery/power/terminal,
/obj/structure/cable{
	icon_state = "0-8"
	},
/obj/machinery/light/broken{
	dir = 4
	},
/obj/effect/decal/cleanable/dirt/dust,
/turf/open/floor/wood,
/area/ship/bridge)
"qk" = (
/obj/structure/cable{
	icon_state = "1-8"
	},
/obj/structure/flora/junglebush/c,
/turf/open/floor/grass,
/area/ship/crew/hydroponics)
"qz" = (
/obj/structure/cable{
	icon_state = "1-2"
	},
/obj/structure/flora/ausbushes/ywflowers,
/turf/open/floor/grass,
/area/ship/bridge)
"qC" = (
/obj/structure/cable{
	icon_state = "1-8"
	},
/obj/effect/decal/cleanable/dirt/dust,
/turf/open/floor/wood{
	icon_state = "wood-broken3"
	},
/area/ship/bridge)
"qP" = (
/obj/machinery/suit_storage_unit/standard_unit,
/turf/open/floor/wood,
/area/ship/bridge)
"rn" = (
/obj/machinery/power/shuttle/engine/electric{
	dir = 1
	},
/obj/structure/cable,
/turf/open/floor/plating,
/area/ship/bridge)
"rG" = (
/obj/structure/holosign/barrier,
/obj/effect/decal/cleanable/blood/gibs,
/obj/effect/decal/cleanable/blood/tracks,
/turf/open/floor/grass,
/area/ship/bridge)
"rH" = (
/obj/machinery/power/terminal,
/obj/structure/cable{
	icon_state = "0-4"
	},
/obj/structure/cable{
	icon_state = "2-4"
	},
/obj/machinery/hydroponics/constructable,
/turf/open/floor/grass/fairy,
/area/ship/crew/hydroponics)
"rM" = (
/obj/effect/spawner/structure/window/reinforced,
/obj/machinery/door/poddoor/shutters/preopen{
	id = "botnbotany"
	},
/turf/open/floor/plating,
/area/ship/crew/hydroponics)
"rQ" = (
/obj/structure/window/reinforced,
/obj/machinery/power/smes/shuttle/precharged{
	dir = 1
	},
/obj/structure/cable{
	icon_state = "0-2"
	},
/obj/machinery/door/poddoor/shutters/preopen{
	id = "botnbotany"
	},
/turf/open/floor/plating,
/area/ship/crew/hydroponics)
"se" = (
/obj/item/vending_refill/hydronutrients,
/obj/item/vending_refill/hydronutrients,
/obj/item/vending_refill/hydroseeds,
/obj/item/vending_refill/hydroseeds,
/obj/structure/closet/crate/large,
/obj/item/storage/box/lights/tubes,
/turf/open/floor/grass,
/area/ship/bridge)
"sF" = (
/obj/machinery/power/apc/auto_name/south,
/obj/structure/cable{
	icon_state = "4-8"
	},
/obj/structure/cable{
	icon_state = "0-4"
	},
/obj/effect/decal/cleanable/dirt/dust,
/turf/open/floor/wood,
/area/ship/bridge)
"tp" = (
/obj/structure/flora/junglebush,
/turf/open/floor/grass,
/area/ship/crew/hydroponics)
"ua" = (
/obj/structure/cable{
	icon_state = "1-4"
	},
/turf/open/floor/wood,
/area/ship/bridge)
"ub" = (
/obj/structure/cable{
	icon_state = "4-8"
	},
/obj/effect/decal/cleanable/dirt/dust,
/obj/machinery/button/door{
	id = "botnbridge";
	pixel_y = -28;
	pixel_x = -5;
	name = "Bridge Shutters"
	},
/obj/machinery/button/door{
	id = "botnbridge";
	pixel_y = -28;
	pixel_x = 5;
	name = "Botany Shutters"
	},
/turf/open/floor/wood{
	icon_state = "wood-broken5"
	},
/area/ship/bridge)
"ux" = (
/turf/open/floor/wood,
/area/ship/bridge)
"vb" = (
/obj/structure/chair/wood{
	dir = 1
	},
/turf/open/floor/wood,
/area/ship/bridge)
"vo" = (
/obj/effect/decal/cleanable/blood/gibs/up,
/turf/open/floor/wood,
/area/ship/bridge)
"vq" = (
/obj/effect/decal/cleanable/blood/gibs/body,
/obj/effect/decal/cleanable/blood/tracks,
/turf/open/floor/grass,
/area/ship/bridge)
"wg" = (
/obj/structure/cable{
	icon_state = "1-2"
	},
/obj/structure/flora/junglebush,
/turf/open/floor/grass,
/area/ship/crew/hydroponics)
"wB" = (
/obj/effect/decal/cleanable/dirt/dust,
/obj/structure/flora/ausbushes/ppflowers,
/turf/open/floor/grass,
/area/ship/bridge)
"wK" = (
/obj/structure/cable{
	icon_state = "1-2"
	},
/obj/structure/flora/ausbushes/brflowers,
/turf/open/floor/grass,
/area/ship/bridge)
"wN" = (
/turf/template_noop,
/area/template_noop)
"xs" = (
/obj/structure/flora/ausbushes/ywflowers,
/turf/open/floor/grass,
/area/ship/bridge)
"xI" = (
/obj/structure/window/reinforced,
/obj/machinery/power/smes/shuttle/precharged{
	dir = 1
	},
/obj/structure/cable{
	icon_state = "1-8"
	},
/obj/structure/cable{
	icon_state = "0-2"
	},
/obj/machinery/door/poddoor/shutters/preopen{
	id = "botnbotany"
	},
/turf/open/floor/plating,
/area/ship/crew/hydroponics)
"xK" = (
/obj/machinery/power/smes/engineering,
/obj/structure/cable{
	icon_state = "4-8"
	},
/obj/structure/cable{
	icon_state = "0-4"
	},
/obj/structure/window/reinforced,
/obj/machinery/door/poddoor/shutters/preopen{
	id = "botnbotany"
	},
/turf/open/floor/plating,
/area/ship/crew/hydroponics)
"yp" = (
/obj/structure/closet/crate,
/obj/item/storage/box/stockparts/basic,
/obj/item/circuitboard/machine/autolathe,
/obj/item/pickaxe,
/obj/item/pickaxe,
/obj/item/mining_scanner,
/obj/item/mining_scanner,
/obj/item/areaeditor/shuttle,
/obj/item/storage/toolbox/mechanical,
/obj/item/storage/box/disks_plantgene,
/turf/open/floor/grass,
/area/ship/bridge)
"yu" = (
/obj/structure/window/reinforced,
/obj/machinery/power/smes/shuttle/precharged{
	dir = 1
	},
/obj/structure/cable{
	icon_state = "0-2"
	},
/obj/machinery/door/poddoor/shutters{
	id = "botnbridge"
	},
/turf/open/floor/plating,
/area/ship/bridge)
"zt" = (
/obj/machinery/power/terminal,
/obj/structure/cable{
	icon_state = "0-4"
	},
/obj/machinery/light/dim{
	dir = 8
	},
/obj/structure/cable{
	icon_state = "1-4"
	},
/turf/open/floor/wood{
	icon_state = "wood-broken7"
	},
/area/ship/bridge)
"zL" = (
/obj/machinery/vending/hydroseeds{
	all_items_free = 1
	},
/turf/open/floor/grass,
/area/ship/crew/hydroponics)
"AI" = (
/obj/machinery/hydroponics/constructable,
/obj/structure/cable{
	icon_state = "1-8"
	},
/turf/open/floor/grass/fairy,
/area/ship/crew/hydroponics)
"Bx" = (
/obj/machinery/vending/hydronutrients{
	all_items_free = 1
	},
/turf/open/floor/grass,
/area/ship/crew/hydroponics)
"BA" = (
/obj/effect/decal/cleanable/dirt/dust,
/obj/structure/flora/junglebush/b,
/turf/open/floor/grass,
/area/ship/bridge)
"BZ" = (
/turf/open/floor/wood{
	icon_state = "wood-broken6"
	},
/area/ship/bridge)
"Ch" = (
/obj/machinery/smartfridge/disks,
/obj/structure/table/glass{
	layer = 2.6
	},
/obj/item/storage/box/disks_plantgene{
	pixel_x = null;
	pixel_y = 8;
	layer = 2.7
	},
/obj/effect/decal/cleanable/dirt/dust,
/turf/open/floor/grass,
/area/ship/crew/hydroponics)
"CD" = (
/obj/machinery/light/dim,
/obj/machinery/suit_storage_unit/standard_unit,
/turf/open/floor/wood{
	icon_state = "wood-broken5"
	},
/area/ship/bridge)
"CK" = (
/obj/effect/decal/cleanable/dirt/dust,
/obj/machinery/door/window{
	dir = 4
	},
/turf/open/floor/wood,
/area/ship/crew/dorm)
"CL" = (
/obj/effect/decal/cleanable/dirt/dust,
/obj/structure/flora/ausbushes/ppflowers,
/turf/open/floor/grass,
/area/ship/crew/hydroponics)
"CZ" = (
/obj/effect/decal/cleanable/dirt/dust,
/turf/open/floor/wood,
/area/ship/bridge)
"Df" = (
/obj/effect/spawner/structure/window/reinforced,
/obj/machinery/door/poddoor/shutters{
	id = "botnbridge"
	},
/turf/open/floor/plating,
/area/ship/crew/dorm)
"DJ" = (
/obj/structure/window/reinforced,
/obj/machinery/power/smes/shuttle/precharged{
	dir = 1
	},
/obj/structure/cable{
	icon_state = "1-4"
	},
/obj/structure/cable{
	icon_state = "0-2"
	},
/obj/machinery/door/poddoor/shutters/preopen{
	id = "botnbotany"
	},
/turf/open/floor/plating,
/area/ship/crew/hydroponics)
"EQ" = (
/obj/machinery/power/terminal,
/obj/machinery/hydroponics/constructable,
/obj/structure/cable{
	icon_state = "0-8"
	},
/obj/machinery/light/broken{
	dir = 4
	},
/turf/open/floor/grass,
/area/ship/crew/hydroponics)
"Fq" = (
/obj/effect/decal/cleanable/dirt/dust,
/obj/structure/flora/ausbushes/ywflowers,
/turf/open/floor/grass,
/area/ship/crew/hydroponics)
"Fw" = (
/turf/open/floor/wood,
/area/ship/crew/hydroponics)
"Gx" = (
/obj/machinery/chem_master/condimaster,
/turf/open/floor/wood,
/area/ship/crew/hydroponics)
"GZ" = (
/obj/structure/flora/ausbushes/lavendergrass,
/turf/open/floor/grass/fairy,
/area/ship/crew/hydroponics)
"He" = (
/obj/machinery/light/broken{
	dir = 4
	},
/turf/open/floor/wood,
/area/ship/bridge)
"Hh" = (
/obj/effect/decal/cleanable/dirt/dust,
/obj/machinery/cryopod{
	dir = 4
	},
/obj/structure/window/reinforced/tinted{
	dir = 4
	},
/obj/machinery/computer/cryopod{
	pixel_y = 32
	},
/turf/open/floor/wood{
	icon_state = "wood-broken5"
	},
/area/ship/crew/dorm)
"Ho" = (
/obj/structure/holosign/barrier,
/turf/open/floor/wood,
/area/ship/bridge)
"Hq" = (
/obj/structure/flora/ausbushes/sparsegrass,
/turf/open/floor/grass,
/area/ship/crew/hydroponics)
"JM" = (
/obj/machinery/plantgenes,
/obj/structure/table/glass,
/turf/open/floor/grass,
/area/ship/crew/hydroponics)
"Kg" = (
/obj/effect/decal/cleanable/dirt/dust,
/obj/structure/flora/junglebush,
/turf/open/floor/grass,
/area/ship/bridge)
"KR" = (
/obj/machinery/door/airlock,
/obj/structure/cable{
	icon_state = "1-2"
	},
/turf/open/floor/grass,
/area/ship/bridge)
"LF" = (
/obj/structure/window/reinforced/tinted{
	dir = 4
	},
/obj/structure/curtain/cloth/fancy,
/obj/structure/bed,
/obj/item/bedsheet/dorms,
/obj/machinery/power/apc/auto_name/south,
/obj/structure/cable{
	icon_state = "0-4"
	},
/turf/open/floor/wood,
/area/ship/crew/dorm)
"LM" = (
/obj/structure/flora/ausbushes/ppflowers,
/turf/open/floor/grass,
/area/ship/bridge)
"Md" = (
/obj/machinery/hydroponics/constructable,
/turf/open/floor/grass,
/area/ship/crew/hydroponics)
"Mp" = (
/obj/structure/cable{
	icon_state = "2-8"
	},
/obj/structure/cable{
	icon_state = "1-2"
	},
/obj/structure/flora/ausbushes/ppflowers,
/turf/open/floor/grass,
/area/ship/crew/hydroponics)
"Nk" = (
/turf/closed/wall,
/area/ship/crew/hydroponics)
"NJ" = (
/obj/machinery/light/broken{
	dir = 8
	},
/turf/open/floor/wood,
/area/ship/bridge)
"NL" = (
/obj/structure/flora/junglebush/c,
/turf/open/floor/grass,
/area/ship/crew/hydroponics)
"Op" = (
/mob/living/simple_animal/hostile/venus_human_trap{
	name = "Jerry the Plant";
	faction = list("neutral","vines","plants")
	},
/obj/structure/closet,
/turf/open/floor/grass,
/area/ship/bridge)
"OB" = (
/turf/open/floor/wood{
	icon_state = "wood-broken"
	},
/area/ship/bridge)
"OH" = (
/turf/closed/wall,
/area/ship/bridge)
"Pk" = (
/obj/machinery/door/airlock,
/obj/structure/cable{
	icon_state = "1-2"
	},
/obj/structure/cable{
	icon_state = "1-2"
	},
/turf/open/floor/grass,
/area/ship/crew/hydroponics)
"PN" = (
/obj/item/stack/sheet/mineral/plasma/five,
/obj/item/stack/sheet/metal/fifty,
/obj/item/stack/sheet/glass/fifty,
/obj/structure/closet/crate/large,
/turf/open/floor/grass,
/area/ship/bridge)
"QD" = (
/obj/structure/table/glass{
	layer = 2.6
	},
/obj/item/storage/bag/plants/portaseeder{
	pixel_y = 8
	},
/obj/item/storage/bag/plants/portaseeder{
	pixel_y = 6
	},
/obj/item/storage/bag/plants/portaseeder{
	pixel_y = 4
	},
/obj/machinery/light/broken{
	dir = 4
	},
/turf/open/floor/wood,
/area/ship/crew/hydroponics)
"Rd" = (
/obj/machinery/power/terminal,
/obj/structure/cable{
	icon_state = "0-4"
	},
/obj/machinery/hydroponics/constructable,
/obj/machinery/light/broken{
	dir = 8
	},
/turf/open/floor/grass,
/area/ship/crew/hydroponics)
"Rh" = (
/obj/structure/tank_dispenser/oxygen,
/turf/open/floor/wood,
/area/ship/bridge)
"RA" = (
/obj/machinery/door/airlock/external,
/obj/structure/fans/tiny,
/turf/open/floor/plating,
/area/ship/bridge)
"RC" = (
/obj/machinery/power/terminal,
/obj/structure/cable{
	icon_state = "2-8"
	},
/obj/structure/cable{
	icon_state = "0-8"
	},
/obj/machinery/hydroponics/constructable,
/turf/open/floor/grass/fairy,
/area/ship/crew/hydroponics)
"RY" = (
/obj/structure/cable{
	icon_state = "1-2"
	},
/obj/structure/flora/ausbushes/sparsegrass,
/turf/open/floor/grass,
/area/ship/crew/hydroponics)
"SD" = (
/obj/machinery/computer/helm,
/turf/open/floor/wood,
/area/ship/bridge)
"TA" = (
/obj/structure/reagent_dispensers/watertank/high,
/turf/open/floor/grass,
/area/ship/bridge)
"Vn" = (
/obj/structure/flora/junglebush/large,
/turf/open/floor/grass,
/area/ship/bridge)
"WS" = (
/obj/structure/flora/ausbushes/brflowers,
/turf/open/floor/grass,
/area/ship/bridge)
"WX" = (
/obj/machinery/seed_extractor,
/turf/open/floor/grass,
/area/ship/crew/hydroponics)
"Xj" = (
/obj/machinery/biogenerator,
/turf/open/floor/grass,
/area/ship/crew/hydroponics)
"YW" = (
/obj/machinery/power/apc/auto_name/north,
/obj/structure/cable{
	icon_state = "0-2"
	},
/obj/structure/cable{
	icon_state = "2-4"
	},
/turf/open/floor/wood,
/area/ship/crew/hydroponics)
"Zj" = (
/obj/structure/cable{
	icon_state = "2-4"
	},
/turf/open/floor/wood,
/area/ship/bridge)
"ZT" = (
/obj/effect/decal/cleanable/blood/bubblegum,
/turf/open/floor/wood,
/area/ship/bridge)

(1,1,1) = {"
wN
wN
wN
OH
Df
Df
Df
OH
wN
wN
wN
wN
wN
wN
wN
Nk
rM
rM
rM
Nk
wN
wN
wN
"}
(2,1,1) = {"
wN
wN
OH
OH
Hh
CK
LF
OH
OH
wN
wN
wN
wN
wN
Nk
Nk
dt
Md
Md
Nk
Nk
wN
wN
"}
(3,1,1) = {"
wN
kd
kd
NJ
ux
bn
eq
zt
yu
rn
wN
wN
wN
Nk
Nk
jl
kR
eJ
gN
Rd
rQ
bt
wN
"}
(4,1,1) = {"
wN
kd
BZ
bP
xs
fA
LM
kW
ua
OH
OH
RA
OH
Nk
Gx
bL
RY
ht
wg
Mp
bj
rM
wN
"}
(5,1,1) = {"
kd
kd
CZ
BA
yp
PN
eZ
xs
sF
OH
oz
OB
qP
Nk
YW
mL
WX
Xj
gN
hQ
RC
DJ
bt
"}
(6,1,1) = {"
jQ
SD
vb
WS
wB
Vn
xs
Kg
hG
KR
wK
cC
qz
Pk
qk
Fq
JM
Ch
Hq
dl
le
xK
wN
"}
(7,1,1) = {"
kd
kd
mm
fA
se
fA
wB
TA
ub
OH
Rh
ux
CD
Nk
pb
kR
zL
Bx
fk
GZ
rH
xI
bt
"}
(8,1,1) = {"
wN
kd
CZ
OB
vq
rG
bn
Zj
qC
OH
OH
RA
OH
Nk
oB
Fw
tp
pu
NL
lF
AI
rM
wN
"}
(9,1,1) = {"
wN
kd
kd
He
Ho
Op
Ho
pZ
yu
rn
wN
wN
wN
Nk
Nk
QD
CL
Hq
kR
EQ
rQ
bt
wN
"}
(10,1,1) = {"
wN
wN
OH
OH
vo
Ho
ZT
OH
OH
wN
wN
wN
wN
wN
Nk
Nk
Md
dt
Md
Nk
Nk
wN
wN
"}
(11,1,1) = {"
wN
wN
wN
OH
kd
kd
kd
OH
wN
wN
wN
wN
wN
wN
wN
Nk
rM
rM
rM
Nk
wN
wN
wN
"}
