//MAP CONVERTED BY dmm2tgm.py THIS HEADER COMMENT PREVENTS RECONVERSION, DO NOT REMOVE
"a" = (
/obj/structure/cable{
	icon_state = "1-2"
	},
/obj/structure/closet/crate,
/obj/item/stack/sheet/metal/ten,
/obj/item/stack/sheet/glass{
	amount = 10
	},
/obj/item/stack/sheet/mineral/plasma/five,
/obj/effect/turf_decal/trimline/green/filled/line{
	dir = 8
	},
/turf/open/floor/iron,
/area/ship/crew/hydroponics)
"b" = (
/obj/machinery/power/shuttle/engine/electric{
	dir = 1
	},
/obj/structure/cable,
/turf/open/floor/plating,
/area/ship/external)
"c" = (
/obj/effect/turf_decal/trimline/green/filled/line{
	dir = 5
	},
/obj/effect/turf_decal/trimline/green/filled/corner{
	dir = 8
	},
/turf/open/floor/iron,
/area/ship/crew/hydroponics)
"d" = (
/obj/machinery/power/terminal,
/obj/structure/cable/yellow{
	icon_state = "0-2"
	},
/obj/machinery/power/port_gen/pacman{
	anchored = 1
	},
/turf/open/floor/plating,
/area/ship/crew/hydroponics)
"e" = (
/obj/structure/window/reinforced,
/obj/machinery/power/smes/shuttle/precharged{
	dir = 1
	},
/obj/structure/cable{
	icon_state = "0-2"
	},
/turf/open/floor/plating,
/area/ship/crew/hydroponics)
"f" = (
/obj/structure/cable{
	icon_state = "0-2"
	},
/obj/machinery/power/apc/auto_name/west{
	dir = 4
	},
/obj/structure/closet/crate,
/obj/item/storage/box/stockparts/basic,
/obj/item/circuitboard/machine/autolathe,
/obj/item/pickaxe,
/obj/item/pickaxe,
/obj/item/mining_scanner,
/obj/item/mining_scanner,
/obj/item/areaeditor/shuttle,
/obj/effect/turf_decal/trimline/green/filled/line{
	dir = 8
	},
/obj/item/storage/toolbox/mechanical,
/obj/item/storage/box/disks_plantgene,
/turf/open/floor/iron,
/area/ship/crew/hydroponics)
"g" = (
/obj/effect/turf_decal/trimline/green/filled/line{
	dir = 8
	},
/turf/open/floor/iron,
/area/ship/crew/hydroponics)
"h" = (
/obj/effect/turf_decal/trimline/green/filled/line,
/obj/effect/turf_decal/trimline/green/filled/corner{
	dir = 4
	},
/turf/open/floor/iron,
/area/ship/crew/hydroponics)
"i" = (
/obj/structure/fans/tiny,
/obj/machinery/door/airlock/external,
/turf/open/floor/plating,
/area/ship/crew/hydroponics)
"k" = (
/obj/machinery/light{
	dir = 8
	},
/obj/effect/turf_decal/trimline/green/filled/line{
	dir = 8
	},
/turf/open/floor/iron,
/area/ship/crew/hydroponics)
"m" = (
/obj/machinery/plantgenes,
/obj/structure/table/glass,
/turf/open/floor/plating/grass,
/area/ship/crew/hydroponics)
"n" = (
/obj/effect/turf_decal/trimline/green/filled/line{
	dir = 6
	},
/obj/effect/turf_decal/trimline/green/filled/corner{
	dir = 1
	},
/turf/open/floor/iron,
/area/ship/crew/hydroponics)
"o" = (
/obj/machinery/light/small{
	dir = 8
	},
/obj/machinery/cryopod{
	dir = 4
	},
/obj/machinery/computer/cryopod{
	pixel_x = -32
	},
/turf/open/floor/wood,
/area/ship/crew/hydroponics)
"p" = (
/obj/machinery/vending/hydronutrients,
/turf/open/floor/plating/grass,
/area/ship/crew/hydroponics)
"q" = (
/obj/effect/turf_decal/trimline/green/filled/line{
	dir = 4
	},
/obj/effect/turf_decal/trimline/green/filled/line{
	dir = 8
	},
/turf/open/floor/iron,
/area/ship/crew/hydroponics)
"t" = (
/obj/machinery/biogenerator,
/turf/open/floor/plating/grass,
/area/ship/crew/hydroponics)
"u" = (
/obj/effect/turf_decal/trimline/green/filled/line{
	dir = 4
	},
/turf/open/floor/iron,
/area/ship/crew/hydroponics)
"v" = (
/obj/structure/chair/wood{
	dir = 1
	},
/obj/effect/turf_decal/trimline/green/filled/corner{
	dir = 8
	},
/obj/effect/turf_decal/trimline/green/filled/corner{
	dir = 1
	},
/turf/open/floor/iron,
/area/ship/crew/hydroponics)
"w" = (
/turf/closed/wall,
/area/ship/crew/hydroponics)
"x" = (
/obj/machinery/hydroponics/constructable,
/turf/open/floor/plating/grass,
/area/ship/crew/hydroponics)
"y" = (
/obj/machinery/power/terminal,
/obj/structure/cable{
	icon_state = "0-4"
	},
/obj/machinery/hydroponics/constructable,
/turf/open/floor/plating/grass,
/area/ship/crew/hydroponics)
"z" = (
/obj/structure/cable{
	icon_state = "4-8"
	},
/obj/machinery/hydroponics/constructable,
/turf/open/floor/plating/grass,
/area/ship/crew/hydroponics)
"A" = (
/obj/effect/turf_decal/trimline/green/filled/line{
	dir = 1
	},
/obj/effect/turf_decal/trimline/green/filled/corner,
/turf/open/floor/iron,
/area/ship/crew/hydroponics)
"B" = (
/obj/machinery/power/terminal,
/obj/structure/cable{
	icon_state = "0-8"
	},
/obj/machinery/hydroponics/constructable,
/turf/open/floor/plating/grass,
/area/ship/crew/hydroponics)
"D" = (
/obj/machinery/smartfridge/disks,
/obj/structure/table/glass,
/turf/open/floor/plating/grass,
/area/ship/crew/hydroponics)
"E" = (
/obj/effect/turf_decal/trimline/green/filled/corner,
/obj/effect/turf_decal/trimline/green/filled/corner{
	dir = 4
	},
/turf/open/floor/iron,
/area/ship/crew/hydroponics)
"F" = (
/obj/machinery/computer/autopilot{
	dir = 4
	},
/obj/effect/turf_decal/trimline/green/filled/end{
	dir = 8
	},
/turf/open/floor/iron,
/area/ship/crew/hydroponics)
"G" = (
/obj/machinery/light{
	dir = 4
	},
/obj/effect/turf_decal/trimline/green/filled/line{
	dir = 4
	},
/obj/effect/turf_decal/trimline/green/filled/line{
	dir = 8
	},
/turf/open/floor/iron,
/area/ship/crew/hydroponics)
"H" = (
/obj/machinery/power/terminal,
/obj/structure/cable{
	icon_state = "0-4"
	},
/obj/structure/cable{
	icon_state = "2-4"
	},
/obj/machinery/hydroponics/constructable,
/turf/open/floor/plating/grass,
/area/ship/crew/hydroponics)
"I" = (
/obj/effect/turf_decal/trimline/green/filled/line{
	dir = 1
	},
/obj/effect/turf_decal/trimline/green/filled/line,
/turf/open/floor/iron,
/area/ship/crew/hydroponics)
"J" = (
/obj/structure/window/reinforced,
/obj/machinery/power/smes/shuttle/precharged{
	dir = 1
	},
/obj/structure/cable{
	icon_state = "1-4"
	},
/obj/structure/cable{
	icon_state = "0-2"
	},
/turf/open/floor/plating,
/area/ship/crew/hydroponics)
"M" = (
/obj/machinery/door/airlock,
/obj/effect/turf_decal/siding/thinplating/dark{
	dir = 8
	},
/obj/effect/turf_decal/siding/thinplating/dark{
	dir = 4
	},
/turf/open/floor/iron/dark/smooth_large,
/area/ship/crew/hydroponics)
"N" = (
/obj/machinery/power/smes/engineering,
/obj/structure/cable{
	icon_state = "4-8"
	},
/obj/structure/cable{
	icon_state = "0-4"
	},
/obj/structure/cable/yellow,
/obj/structure/window/reinforced,
/turf/open/floor/plating,
/area/ship/crew/hydroponics)
"P" = (
/obj/machinery/light{
	dir = 8
	},
/obj/effect/turf_decal/trimline/green/filled/end{
	dir = 8
	},
/turf/open/floor/iron,
/area/ship/crew/hydroponics)
"Q" = (
/obj/structure/cable{
	icon_state = "1-2"
	},
/obj/effect/turf_decal/trimline/green/filled/line,
/obj/effect/turf_decal/trimline/green/filled/corner{
	dir = 1
	},
/turf/open/floor/iron,
/area/ship/crew/hydroponics)
"R" = (
/obj/machinery/vending/hydroseeds,
/turf/open/floor/plating/grass,
/area/ship/crew/hydroponics)
"S" = (
/obj/effect/turf_decal/trimline/green/filled/line{
	dir = 4
	},
/obj/effect/turf_decal/trimline/green/filled/corner{
	dir = 8
	},
/obj/effect/turf_decal/trimline/green/filled/corner{
	dir = 1
	},
/turf/open/floor/iron,
/area/ship/crew/hydroponics)
"T" = (
/turf/template_noop,
/area/template_noop)
"V" = (
/obj/effect/spawner/structure/window/reinforced,
/turf/open/floor/plating,
/area/ship/crew/hydroponics)
"W" = (
/obj/machinery/power/terminal,
/obj/structure/cable{
	icon_state = "1-8"
	},
/obj/structure/cable{
	icon_state = "2-8"
	},
/obj/structure/cable{
	icon_state = "0-8"
	},
/obj/machinery/hydroponics/constructable,
/turf/open/floor/plating/grass,
/area/ship/crew/hydroponics)
"X" = (
/obj/machinery/computer/helm,
/obj/effect/turf_decal/trimline/green/filled/line{
	dir = 9
	},
/turf/open/floor/iron,
/area/ship/crew/hydroponics)
"Y" = (
/obj/machinery/seed_extractor,
/turf/open/floor/plating/grass,
/area/ship/crew/hydroponics)
"Z" = (
/obj/structure/window/reinforced,
/obj/machinery/power/smes/shuttle/precharged{
	dir = 1
	},
/obj/structure/cable{
	icon_state = "1-8"
	},
/obj/structure/cable{
	icon_state = "0-2"
	},
/turf/open/floor/plating,
/area/ship/crew/hydroponics)

(1,1,1) = {"
T
T
T
w
w
w
w
w
w
w
T
"}
(2,1,1) = {"
T
V
V
w
o
w
R
P
y
e
b
"}
(3,1,1) = {"
V
V
F
w
M
w
p
I
z
V
T
"}
(4,1,1) = {"
V
X
v
k
g
f
a
Q
W
J
b
"}
(5,1,1) = {"
V
A
u
u
E
u
u
h
d
N
T
"}
(6,1,1) = {"
V
I
x
x
I
Y
t
I
H
Z
b
"}
(7,1,1) = {"
V
I
x
x
I
m
D
I
z
V
T
"}
(8,1,1) = {"
V
c
q
G
S
q
G
n
B
e
b
"}
(9,1,1) = {"
V
V
V
w
i
w
w
w
w
w
T
"}
