//MAP CONVERTED BY dmm2tgm.py THIS HEADER COMMENT PREVENTS RECONVERSION, DO NOT REMOVE
"aa" = (
/obj/structure/chair/comfy/shuttle{
	dir = 1
	},
/obj/machinery/light/small{
	dir = 8
	},
/obj/machinery/airalarm/all_access{
	dir = 4;
	pixel_x = -24
	},
/obj/machinery/atmospherics/components/unary/vent_pump/on,
/obj/effect/decal/cleanable/dirt,
/turf/open/floor/pod/dark,
/area/ship/cargo)
"ab" = (
/obj/structure/table,
/obj/effect/decal/cleanable/dirt,
/obj/machinery/recharger,
/turf/open/floor/plasteel/dark,
/area/ship/bridge)
"ac" = (
/obj/effect/decal/cleanable/dirt,
/obj/machinery/computer/helm,
/turf/open/floor/plasteel/dark,
/area/ship/bridge)
"ad" = (
/obj/structure/table,
/obj/machinery/button/door{
	id = "piratebridge";
	name = "Bridge Shutters Control";
	pixel_y = -5
	},
/obj/item/radio/intercom{
	pixel_y = 5
	},
/obj/effect/decal/cleanable/dirt,
/obj/item/areaeditor/shuttle,
/turf/open/floor/plasteel/dark,
/area/ship/bridge)
"ae" = (
/obj/effect/decal/cleanable/dirt,
/turf/open/floor/plasteel/dark,
/area/ship/bridge)
"af" = (
/turf/template_noop,
/area/template_noop)
"ag" = (
/obj/structure/chair/comfy/shuttle{
	dir = 1
	},
/turf/open/floor/plasteel/dark,
/area/ship/bridge)
"ah" = (
/turf/closed/wall/mineral/titanium/nodiagonal,
/area/ship/engineering/engine)
"ai" = (
/obj/machinery/atmospherics/components/unary/vent_pump/on{
	dir = 1
	},
/obj/effect/decal/cleanable/dirt,
/obj/machinery/light/small,
/obj/machinery/suit_storage_unit/ert/security,
/turf/open/floor/pod/dark,
/area/ship/security/armory)
"aj" = (
/turf/closed/wall/mineral/titanium/nodiagonal,
/area/ship/bridge)
"al" = (
/obj/effect/decal/cleanable/dirt,
/obj/machinery/computer/communications{
	dir = 8
	},
/turf/open/floor/plasteel/dark,
/area/ship/bridge)
"am" = (
/obj/machinery/atmospherics/components/unary/vent_pump/on,
/obj/structure/cable{
	icon_state = "2-8"
	},
/turf/open/floor/plasteel/dark,
/area/ship/bridge)
"an" = (
/obj/machinery/button/door{
	id = "piratebridgebolt";
	name = "Bridge Bolt Control";
	normaldoorcontrol = 1;
	pixel_y = -24;
	specialfunctions = 4
	},
/turf/open/floor/plasteel/dark,
/area/ship/bridge)
"ao" = (
/obj/structure/chair/comfy/shuttle{
	dir = 1
	},
/obj/machinery/light/small{
	dir = 4
	},
/obj/machinery/airalarm/all_access{
	dir = 8;
	pixel_x = 24
	},
/obj/machinery/atmospherics/components/unary/vent_pump/on,
/obj/effect/decal/cleanable/dirt,
/turf/open/floor/pod/dark,
/area/ship/medical)
"ap" = (
/obj/machinery/door/airlock/hatch{
	name = "Port Gun Battery"
	},
/obj/machinery/atmospherics/pipe/simple/supply/hidden,
/obj/effect/decal/cleanable/dirt,
/obj/machinery/door/firedoor/border_only{
	dir = 1
	},
/obj/machinery/door/firedoor/border_only,
/turf/open/floor/pod/dark,
/area/ship/cargo)
"aq" = (
/obj/machinery/atmospherics/components/unary/vent_pump/on{
	dir = 4
	},
/obj/effect/decal/cleanable/dirt,
/turf/open/floor/plasteel,
/area/ship/cargo)
"as" = (
/obj/machinery/door/poddoor/shutters/preopen{
	id = "piratebridge"
	},
/obj/machinery/door/firedoor/border_only{
	dir = 1
	},
/obj/machinery/door/firedoor/border_only{
	dir = 8
	},
/obj/effect/spawner/structure/window/shuttle,
/turf/open/floor/plating,
/area/ship/bridge)
"at" = (
/obj/machinery/door/poddoor/shutters/preopen{
	id = "piratebridge"
	},
/obj/machinery/door/firedoor/border_only{
	dir = 1
	},
/obj/effect/spawner/structure/window/shuttle,
/turf/open/floor/plating,
/area/ship/bridge)
"au" = (
/obj/machinery/atmospherics/pipe/simple/supply/hidden,
/obj/machinery/door/firedoor/border_only{
	dir = 1
	},
/obj/machinery/door/firedoor/border_only,
/obj/machinery/door/airlock/command{
	id_tag = "piratebridgebolt";
	name = "Bridge"
	},
/obj/structure/cable{
	icon_state = "1-2"
	},
/turf/open/floor/plasteel/dark,
/area/ship/bridge)
"av" = (
/obj/machinery/door/airlock/hatch{
	name = "Starboard Gun Battery"
	},
/obj/machinery/atmospherics/pipe/simple/supply/hidden,
/obj/effect/decal/cleanable/dirt,
/obj/machinery/door/firedoor/border_only{
	dir = 1
	},
/obj/machinery/door/firedoor/border_only,
/turf/open/floor/plasteel/white,
/area/ship/medical)
"aw" = (
/obj/machinery/atmospherics/pipe/simple/supply/hidden{
	dir = 5
	},
/obj/effect/decal/cleanable/dirt,
/turf/open/floor/plasteel,
/area/ship/cargo)
"ax" = (
/obj/machinery/firealarm{
	pixel_y = 24
	},
/obj/machinery/atmospherics/pipe/simple/supply/hidden{
	dir = 4
	},
/obj/machinery/mineral/ore_redemption{
	dir = 8
	},
/turf/open/floor/plasteel,
/area/ship/cargo)
"ay" = (
/obj/machinery/atmospherics/pipe/simple/supply/hidden{
	dir = 10
	},
/obj/effect/decal/cleanable/dirt,
/turf/open/floor/plasteel,
/area/ship/cargo)
"az" = (
/obj/machinery/selling_pad,
/obj/effect/turf_decal/box,
/turf/open/floor/plasteel,
/area/ship/cargo)
"aA" = (
/obj/machinery/door/poddoor/shutters/preopen{
	id = "piratebridge"
	},
/obj/machinery/door/firedoor/border_only{
	dir = 1
	},
/obj/machinery/door/firedoor/border_only{
	dir = 4
	},
/obj/effect/spawner/structure/window/shuttle,
/turf/open/floor/plating,
/area/ship/bridge)
"aB" = (
/obj/machinery/computer/monitor/secret{
	dir = 8
	},
/obj/effect/decal/cleanable/dirt,
/obj/machinery/airalarm/all_access{
	dir = 1;
	pixel_y = -24
	},
/obj/machinery/light{
	dir = 4
	},
/turf/open/floor/plasteel/dark,
/area/ship/bridge)
"aC" = (
/obj/effect/decal/cleanable/dirt,
/obj/structure/displaycase/captain,
/turf/open/floor/plasteel/dark,
/area/ship/bridge)
"aD" = (
/obj/effect/decal/cleanable/dirt,
/turf/open/floor/plating,
/area/ship/engineering/engine)
"aE" = (
/obj/machinery/door/poddoor/shutters/preopen{
	id = "piratebridge"
	},
/obj/effect/spawner/structure/window/shuttle,
/turf/open/floor/plating,
/area/ship/bridge)
"aF" = (
/obj/machinery/door/airlock/external/glass{
	id_tag = "pirateportexternal"
	},
/obj/effect/mapping_helpers/airlock/locked,
/obj/effect/mapping_helpers/airlock/cyclelink_helper,
/obj/effect/decal/cleanable/dirt,
/obj/machinery/door/firedoor/border_only{
	dir = 1
	},
/obj/machinery/door/firedoor/border_only,
/turf/open/floor/plating,
/area/ship/engineering/engine)
"aG" = (
/obj/effect/decal/cleanable/dirt,
/obj/structure/cable{
	icon_state = "0-4"
	},
/obj/machinery/power/terminal,
/turf/open/floor/plating,
/area/ship/engineering/engine)
"aH" = (
/obj/machinery/power/shuttle/engine/electric{
	dir = 1
	},
/obj/structure/cable,
/turf/open/floor/plating,
/area/ship/cargo)
"aI" = (
/obj/machinery/light/small{
	dir = 8
	},
/obj/structure/sign/warning/vacuum/external{
	pixel_x = -32
	},
/obj/effect/decal/cleanable/dirt,
/turf/open/floor/plating,
/area/ship/engineering/engine)
"aJ" = (
/obj/machinery/door/airlock/external/glass{
	id_tag = "pirateportexternal"
	},
/obj/effect/mapping_helpers/airlock/locked,
/obj/effect/mapping_helpers/airlock/cyclelink_helper{
	dir = 1
	},
/obj/machinery/door/firedoor/border_only{
	dir = 1
	},
/obj/machinery/door/firedoor/border_only,
/obj/structure/fans/tiny,
/turf/open/floor/plating,
/area/ship/engineering/engine)
"aK" = (
/obj/machinery/power/shuttle/engine/fueled/plasma{
	dir = 1
	},
/obj/docking_port/mobile{
	dwidth = 11;
	width = 17;
	height = 16
	},
/turf/open/floor/plating,
/area/ship/engineering/engine)
"aL" = (
/obj/machinery/atmospherics/pipe/manifold/supply/hidden{
	dir = 4
	},
/obj/effect/decal/cleanable/dirt,
/obj/structure/cable{
	icon_state = "1-2"
	},
/turf/open/floor/plating,
/area/ship/engineering/engine)
"aM" = (
/obj/effect/decal/cleanable/dirt,
/obj/machinery/power/terminal,
/obj/structure/cable,
/obj/machinery/computer/cargo/express{
	dir = 1
	},
/turf/open/floor/wood,
/area/ship/cargo)
"aN" = (
/obj/machinery/light/small,
/obj/machinery/button/door{
	id = "pirateportexternal";
	name = "External Bolt Control";
	normaldoorcontrol = 1;
	pixel_x = -4;
	pixel_y = -24;
	specialfunctions = 4
	},
/obj/effect/decal/cleanable/dirt,
/turf/open/floor/plating,
/area/ship/engineering/engine)
"aO" = (
/obj/machinery/light/small,
/obj/machinery/button/door{
	id = "piratestarboardexternal";
	name = "External Bolt Control";
	normaldoorcontrol = 1;
	pixel_x = 4;
	pixel_y = -24;
	specialfunctions = 4
	},
/obj/effect/decal/cleanable/dirt,
/obj/structure/cable{
	icon_state = "1-8"
	},
/obj/machinery/atmospherics/pipe/simple/orange/visible{
	dir = 4
	},
/turf/open/floor/plating,
/area/ship/engineering/engine)
"aP" = (
/obj/machinery/door/poddoor/shutters/preopen{
	id = "piratebridge"
	},
/obj/machinery/door/firedoor/border_only{
	dir = 8
	},
/obj/effect/spawner/structure/window/shuttle,
/turf/open/floor/plating,
/area/ship/bridge)
"aQ" = (
/turf/closed/wall/mineral/titanium/nodiagonal,
/area/ship/cargo)
"aR" = (
/turf/closed/wall/mineral/titanium,
/area/ship/engineering/engine)
"aS" = (
/obj/effect/decal/cleanable/dirt,
/obj/machinery/atmospherics/pipe/simple/orange/visible{
	dir = 9
	},
/turf/open/floor/plating,
/area/ship/engineering/engine)
"aT" = (
/obj/machinery/door/poddoor/shutters/preopen{
	id = "piratebridge"
	},
/obj/machinery/door/firedoor/border_only{
	dir = 4
	},
/obj/effect/spawner/structure/window/shuttle,
/turf/open/floor/plating,
/area/ship/bridge)
"aU" = (
/obj/structure/sign/departments/engineering,
/turf/closed/wall/mineral/titanium/nodiagonal,
/area/ship/engineering/engine)
"aV" = (
/obj/machinery/power/apc/auto_name/west,
/obj/machinery/power/terminal,
/obj/structure/cable,
/turf/open/floor/plasteel/dark,
/area/ship/crew/cryo)
"aW" = (
/obj/effect/decal/cleanable/dirt,
/obj/machinery/firealarm{
	dir = 1;
	pixel_y = -24
	},
/obj/structure/closet/secure_closet/captains,
/obj/machinery/light{
	dir = 8
	},
/turf/open/floor/plasteel/dark,
/area/ship/bridge)
"be" = (
/obj/effect/decal/cleanable/dirt,
/obj/structure/rack,
/obj/item/storage/toolbox/mechanical{
	pixel_y = 4
	},
/obj/item/flashlight{
	pixel_x = 3;
	pixel_y = 3
	},
/obj/item/storage/box/lights/bulbs,
/obj/item/stack/sheet/mineral/plasma{
	amount = 10
	},
/obj/item/multitool,
/obj/machinery/atmospherics/pipe/simple/supply/hidden{
	dir = 4
	},
/obj/item/tank/internals/oxygen,
/obj/item/tank/internals/oxygen,
/obj/item/tank/internals/oxygen,
/obj/item/tank/internals/oxygen,
/obj/item/pipe_dispenser,
/turf/open/floor/plating,
/area/ship/engineering/engine)
"bf" = (
/obj/effect/decal/cleanable/dirt,
/obj/machinery/power/apc/auto_name/south,
/obj/structure/cable{
	icon_state = "0-4"
	},
/turf/open/floor/plasteel/dark,
/area/ship/bridge)
"bg" = (
/obj/effect/decal/cleanable/dirt,
/obj/structure/table,
/obj/item/gun/energy/laser{
	pixel_x = -3;
	pixel_y = 6
	},
/obj/item/gun/energy/laser{
	pixel_y = 3
	},
/obj/machinery/door/window/brigdoor{
	req_access_txt = "1";
	name = "Gun Rack Access"
	},
/turf/open/floor/pod/light,
/area/ship/security/armory)
"bk" = (
/obj/structure/cable,
/obj/effect/decal/cleanable/dirt,
/obj/structure/cable{
	icon_state = "1-8"
	},
/obj/machinery/power/terminal,
/turf/open/floor/plating,
/area/ship/engineering/engine)
"bl" = (
/obj/machinery/light/small{
	dir = 1
	},
/obj/effect/decal/cleanable/dirt,
/obj/structure/table,
/obj/item/gun/energy/laser{
	pixel_x = -3;
	pixel_y = 6
	},
/obj/item/gun/energy/laser{
	pixel_y = 3
	},
/obj/machinery/door/window/brigdoor{
	req_access_txt = "1";
	name = "Gun Rack Access"
	},
/obj/structure/window/reinforced/spawner/east,
/turf/open/floor/pod/light,
/area/ship/security/armory)
"bm" = (
/obj/machinery/atmospherics/pipe/simple/supply/hidden,
/obj/structure/cable{
	icon_state = "1-2"
	},
/turf/open/floor/pod/dark,
/area/ship/security/armory)
"bo" = (
/obj/machinery/light/small{
	dir = 4
	},
/obj/structure/sign/warning/vacuum/external{
	pixel_x = 32
	},
/turf/open/floor/plating,
/area/ship/engineering/engine)
"br" = (
/obj/effect/decal/cleanable/dirt,
/obj/machinery/power/terminal,
/obj/structure/cable,
/obj/machinery/modular_computer/console/preset/command{
	dir = 1
	},
/turf/open/floor/wood,
/area/ship/cargo)
"bu" = (
/obj/machinery/firealarm{
	pixel_y = 24
	},
/obj/machinery/atmospherics/pipe/simple/supply/hidden{
	dir = 4
	},
/obj/effect/decal/cleanable/dirt,
/obj/structure/closet/secure_closet{
	icon_state = "med";
	name = "medicine locker"
	},
/obj/item/storage/firstaid/regular,
/obj/item/storage/firstaid/brute,
/obj/item/storage/firstaid/fire,
/obj/item/storage/firstaid/toxin,
/obj/item/storage/firstaid/o2,
/turf/open/floor/plasteel/white,
/area/ship/medical)
"bv" = (
/obj/machinery/atmospherics/pipe/simple/supply/hidden{
	dir = 9
	},
/obj/effect/decal/cleanable/dirt,
/obj/machinery/airalarm/all_access{
	dir = 8;
	pixel_x = 24
	},
/turf/open/floor/plasteel/white,
/area/ship/medical)
"bx" = (
/obj/machinery/atmospherics/pipe/simple/supply/hidden{
	dir = 4
	},
/obj/effect/decal/cleanable/dirt,
/obj/structure/cable{
	icon_state = "4-8"
	},
/turf/open/floor/plasteel,
/area/ship/cargo)
"by" = (
/obj/machinery/atmospherics/pipe/manifold4w/supply/hidden,
/obj/effect/decal/cleanable/dirt,
/obj/structure/cable{
	icon_state = "4-8"
	},
/obj/structure/cable{
	icon_state = "2-8"
	},
/obj/structure/cable{
	icon_state = "2-4"
	},
/obj/structure/cable{
	icon_state = "1-8"
	},
/obj/structure/cable{
	icon_state = "1-4"
	},
/obj/structure/cable{
	icon_state = "1-2"
	},
/turf/open/floor/pod/dark,
/area/ship/security/armory)
"bA" = (
/obj/machinery/atmospherics/pipe/simple/supply/hidden{
	dir = 4
	},
/obj/structure/cable{
	icon_state = "4-8"
	},
/turf/open/floor/pod/dark,
/area/ship/security/armory)
"bB" = (
/obj/effect/decal/cleanable/dirt,
/obj/machinery/atmospherics/pipe/simple/supply/hidden{
	dir = 4
	},
/obj/structure/cable{
	icon_state = "2-8"
	},
/obj/structure/cable{
	icon_state = "4-8"
	},
/turf/open/floor/plasteel/white,
/area/ship/medical)
"bC" = (
/obj/effect/decal/cleanable/dirt,
/obj/machinery/atmospherics/pipe/manifold4w/supply/hidden,
/obj/structure/cable{
	icon_state = "2-8"
	},
/turf/open/floor/plasteel/white,
/area/ship/medical)
"bF" = (
/obj/machinery/button/door{
	id = "collins_cargo";
	pixel_y = -24;
	name = "Cargo Door Controls"
	},
/obj/structure/closet/crate,
/obj/item/reagent_containers/food/snacks/rationpack,
/obj/item/reagent_containers/food/snacks/rationpack,
/obj/item/reagent_containers/food/snacks/rationpack,
/obj/item/reagent_containers/food/snacks/rationpack,
/obj/item/reagent_containers/food/snacks/rationpack,
/obj/item/reagent_containers/food/snacks/rationpack,
/obj/item/reagent_containers/food/snacks/canned/beans,
/obj/item/reagent_containers/food/snacks/canned/beans,
/obj/item/reagent_containers/food/snacks/canned/beans,
/obj/item/reagent_containers/food/snacks/canned/beans,
/obj/item/reagent_containers/food/snacks/canned/beans,
/obj/item/reagent_containers/food/snacks/canned/beans,
/obj/item/reagent_containers/food/drinks/waterbottle/large,
/obj/item/reagent_containers/food/drinks/waterbottle/large,
/obj/item/reagent_containers/food/drinks/waterbottle/large,
/obj/item/reagent_containers/food/drinks/waterbottle/large,
/obj/item/reagent_containers/food/drinks/waterbottle/large,
/obj/item/reagent_containers/food/drinks/waterbottle/large,
/obj/item/reagent_containers/food/drinks/waterbottle/large,
/turf/open/floor/plasteel,
/area/ship/cargo)
"bH" = (
/obj/machinery/light{
	dir = 4
	},
/obj/machinery/computer/selling_pad_control{
	dir = 8
	},
/obj/machinery/airalarm/all_access{
	dir = 1;
	pixel_y = -24
	},
/turf/open/floor/plasteel,
/area/ship/cargo)
"bI" = (
/obj/machinery/light/small,
/obj/machinery/recharger,
/obj/structure/table,
/turf/open/floor/pod/dark,
/area/ship/security/armory)
"bJ" = (
/obj/effect/decal/cleanable/dirt,
/obj/machinery/atmospherics/pipe/simple/supply/hidden,
/obj/structure/cable{
	icon_state = "1-2"
	},
/turf/open/floor/plasteel/white,
/area/ship/medical)
"bK" = (
/obj/machinery/sleeper{
	dir = 8
	},
/turf/open/floor/plasteel/white,
/area/ship/medical)
"bM" = (
/obj/machinery/atmospherics/pipe/simple/supply/hidden,
/obj/machinery/door/airlock{
	name = "Cryogenics"
	},
/obj/effect/decal/cleanable/dirt,
/obj/machinery/door/firedoor/border_only{
	dir = 1
	},
/obj/machinery/door/firedoor/border_only,
/obj/structure/cable{
	icon_state = "1-2"
	},
/turf/open/floor/plasteel/dark,
/area/ship/crew/cryo)
"bO" = (
/obj/effect/decal/cleanable/dirt,
/obj/machinery/power/port_gen/pacman{
	anchored = 1;
	sheets = 35
	},
/obj/machinery/power/terminal{
	dir = 4
	},
/obj/structure/cable{
	icon_state = "0-4"
	},
/turf/open/floor/plating,
/area/ship/engineering/engine)
"bP" = (
/obj/machinery/atmospherics/components/unary/vent_pump/on{
	dir = 1
	},
/obj/effect/decal/cleanable/dirt,
/obj/machinery/atmospherics/pipe/simple/orange/visible{
	dir = 6
	},
/obj/structure/cable{
	icon_state = "1-4"
	},
/turf/open/floor/plating,
/area/ship/engineering/engine)
"bQ" = (
/obj/effect/decal/cleanable/dirt,
/obj/structure/cable{
	icon_state = "2-4"
	},
/obj/machinery/atmospherics/pipe/simple/orange/visible{
	dir = 4
	},
/obj/structure/cable{
	icon_state = "4-8"
	},
/turf/open/floor/plating,
/area/ship/engineering/engine)
"bX" = (
/obj/effect/decal/cleanable/dirt,
/obj/structure/cable{
	icon_state = "4-8"
	},
/obj/machinery/atmospherics/pipe/simple/orange/visible,
/obj/machinery/suit_storage_unit/ert/engineer,
/turf/open/floor/plating,
/area/ship/engineering/engine)
"bZ" = (
/obj/machinery/door/airlock/external/glass{
	id_tag = "piratestarboardexternal"
	},
/obj/effect/mapping_helpers/airlock/locked,
/obj/effect/mapping_helpers/airlock/cyclelink_helper,
/obj/effect/decal/cleanable/dirt,
/obj/machinery/door/firedoor/border_only{
	dir = 1
	},
/obj/machinery/door/firedoor/border_only,
/turf/open/floor/plating,
/area/ship/engineering/engine)
"ce" = (
/obj/machinery/door/airlock/external/glass{
	id_tag = "piratestarboardexternal"
	},
/obj/effect/mapping_helpers/airlock/locked,
/obj/effect/mapping_helpers/airlock/cyclelink_helper{
	dir = 1
	},
/obj/machinery/door/firedoor/border_only{
	dir = 1
	},
/obj/machinery/door/firedoor/border_only,
/obj/structure/fans/tiny,
/turf/open/floor/plating,
/area/ship/engineering/engine)
"df" = (
/turf/closed/wall/mineral/titanium,
/area/ship/crew/cryo)
"dy" = (
/obj/machinery/atmospherics/components/unary/vent_pump/on{
	dir = 1
	},
/obj/machinery/light/small{
	dir = 4
	},
/obj/effect/decal/cleanable/dirt,
/obj/structure/cable{
	icon_state = "1-8"
	},
/obj/structure/cable{
	icon_state = "1-2"
	},
/turf/open/floor/wood,
/area/ship/cargo)
"dL" = (
/turf/closed/wall/mineral/titanium/nodiagonal,
/area/ship/security/armory)
"dU" = (
/obj/machinery/light/small{
	dir = 8
	},
/obj/machinery/atmospherics/components/unary/vent_pump/on{
	dir = 1
	},
/obj/structure/cable{
	icon_state = "1-2"
	},
/obj/structure/cable{
	icon_state = "1-4"
	},
/turf/open/floor/plasteel/dark,
/area/ship/crew/cryo)
"ek" = (
/obj/effect/decal/cleanable/dirt,
/obj/structure/sign/poster/contraband/revolver{
	pixel_x = 32
	},
/obj/machinery/vending/security/marine/solgov{
	all_items_free = 1
	},
/turf/open/floor/pod/light,
/area/ship/security/armory)
"ep" = (
/obj/machinery/atmospherics/components/unary/shuttle/heater{
	dir = 1
	},
/obj/structure/window/plasma/reinforced/spawner,
/obj/machinery/door/window/eastright{
	dir = 1;
	name = "Engine Access"
	},
/turf/open/floor/plating,
/area/ship/engineering/engine)
"er" = (
/obj/machinery/power/shuttle/engine/electric{
	dir = 1
	},
/obj/structure/cable,
/turf/open/floor/plating,
/area/ship/engineering/engine)
"et" = (
/obj/structure/grille,
/turf/open/floor/plating/airless,
/area/ship/medical)
"eu" = (
/obj/structure/girder,
/obj/item/stack/rods{
	amount = 3
	},
/turf/open/floor/plating/airless,
/area/ship/cargo)
"ew" = (
/obj/structure/girder,
/obj/item/stack/rods{
	amount = 5
	},
/turf/open/floor/plating/airless,
/area/ship/medical)
"ex" = (
/obj/structure/window/reinforced,
/obj/structure/frame/machine,
/obj/item/wrench,
/turf/open/floor/plating/airless,
/area/ship/cargo)
"ez" = (
/obj/structure/window/reinforced,
/obj/structure/frame/machine,
/obj/item/stack/cable_coil/cut/red,
/turf/open/floor/plating/airless,
/area/ship/medical)
"eA" = (
/obj/structure/window/reinforced{
	dir = 1;
	pixel_y = 1
	},
/obj/structure/frame/computer{
	anchored = 1
	},
/obj/effect/decal/cleanable/dirt,
/turf/open/floor/pod/dark,
/area/ship/cargo)
"eE" = (
/obj/machinery/atmospherics/pipe/simple/supply/hidden{
	dir = 6
	},
/obj/effect/decal/cleanable/dirt,
/obj/structure/table/optable,
/turf/open/floor/plasteel/white,
/area/ship/medical)
"fW" = (
/turf/closed/wall/mineral/titanium,
/area/ship/medical)
"fY" = (
/obj/machinery/atmospherics/pipe/manifold/supply/hidden{
	dir = 1
	},
/obj/structure/cable{
	icon_state = "4-8"
	},
/turf/open/floor/pod/dark,
/area/ship/security/armory)
"gY" = (
/obj/machinery/atmospherics/pipe/simple/supply/hidden{
	dir = 4
	},
/obj/effect/decal/cleanable/dirt,
/obj/structure/cable{
	icon_state = "4-8"
	},
/obj/structure/cable{
	icon_state = "2-4"
	},
/turf/open/floor/pod/dark,
/area/ship/security/armory)
"jo" = (
/obj/machinery/power/smes/shuttle/precharged{
	dir = 1
	},
/obj/structure/cable{
	icon_state = "0-2"
	},
/obj/structure/window/plasma/reinforced/spawner,
/obj/machinery/door/window/eastright{
	dir = 1;
	name = "Engine Access"
	},
/turf/open/floor/plating,
/area/ship/engineering/engine)
"km" = (
/obj/machinery/atmospherics/components/unary/tank/air,
/obj/machinery/firealarm{
	pixel_y = 24
	},
/obj/effect/decal/cleanable/dirt,
/turf/open/floor/plating,
/area/ship/engineering/engine)
"lC" = (
/obj/effect/decal/cleanable/dirt,
/obj/machinery/atmospherics/components/unary/tank/toxins,
/turf/open/floor/plating,
/area/ship/engineering/engine)
"mD" = (
/obj/effect/decal/cleanable/dirt,
/obj/machinery/computer/operating,
/turf/open/floor/plasteel/white,
/area/ship/medical)
"mU" = (
/obj/machinery/atmospherics/pipe/simple/supply/hidden,
/obj/machinery/door/airlock/engineering{
	name = "Engineering"
	},
/obj/effect/decal/cleanable/dirt,
/obj/machinery/door/firedoor/border_only{
	dir = 1
	},
/obj/machinery/door/firedoor/border_only,
/obj/structure/cable{
	icon_state = "1-2"
	},
/turf/open/floor/pod/dark,
/area/ship/engineering/engine)
"no" = (
/obj/machinery/cryopod,
/obj/structure/sign/poster/contraband/random{
	pixel_x = 32
	},
/obj/machinery/power/terminal,
/obj/structure/cable,
/turf/open/floor/plasteel/dark,
/area/ship/crew/cryo)
"np" = (
/obj/machinery/airalarm/all_access{
	pixel_y = 24
	},
/obj/effect/decal/cleanable/dirt,
/obj/machinery/power/smes/engineering,
/obj/structure/cable{
	icon_state = "0-2"
	},
/turf/open/floor/plating,
/area/ship/engineering/engine)
"vB" = (
/obj/effect/decal/cleanable/dirt,
/obj/machinery/recharger,
/obj/structure/table,
/obj/machinery/airalarm/all_access{
	dir = 8;
	pixel_x = 24
	},
/turf/open/floor/pod/light,
/area/ship/security/armory)
"wf" = (
/turf/open/floor/plasteel/white,
/area/ship/medical)
"wK" = (
/obj/machinery/power/shuttle/engine/electric{
	dir = 1
	},
/obj/structure/cable,
/turf/open/floor/plating,
/area/ship/crew/cryo)
"wP" = (
/turf/open/floor/plasteel,
/area/ship/cargo)
"wR" = (
/turf/closed/wall/mineral/titanium,
/area/ship/cargo)
"yi" = (
/obj/machinery/atmospherics/pipe/simple/supply/hidden{
	dir = 4
	},
/obj/effect/decal/cleanable/dirt,
/obj/machinery/door/firedoor/border_only{
	dir = 4
	},
/obj/machinery/door/firedoor/border_only{
	dir = 8
	},
/obj/structure/cable{
	icon_state = "4-8"
	},
/obj/machinery/door/airlock/medical/glass{
	name = "Medical Bay"
	},
/turf/open/floor/plasteel/white,
/area/ship/security/armory)
"zw" = (
/obj/machinery/atmospherics/pipe/simple/supply/hidden,
/obj/effect/decal/cleanable/dirt,
/obj/machinery/door/firedoor/border_only{
	dir = 1
	},
/obj/machinery/door/firedoor/border_only,
/obj/structure/cable{
	icon_state = "1-2"
	},
/obj/machinery/door/airlock/mining/glass{
	name = "Cargo Office"
	},
/turf/open/floor/wood,
/area/ship/cargo)
"FH" = (
/obj/structure/fans/tiny,
/obj/machinery/door/poddoor{
	id = "collins_cargo"
	},
/turf/open/floor/plating,
/area/ship/cargo)
"Gk" = (
/obj/effect/decal/cleanable/dirt,
/obj/machinery/autolathe,
/turf/open/floor/plating,
/area/ship/engineering/engine)
"GX" = (
/turf/closed/wall/mineral/titanium/nodiagonal,
/area/ship/crew/cryo)
"Jr" = (
/turf/closed/wall/mineral/titanium/nodiagonal,
/area/ship/medical)
"JT" = (
/obj/effect/decal/cleanable/dirt,
/obj/machinery/power/apc/auto_name/west,
/obj/structure/cable,
/obj/machinery/suit_storage_unit/ert/security,
/turf/open/floor/pod/light,
/area/ship/security/armory)
"KQ" = (
/obj/machinery/atmospherics/pipe/simple/supply/hidden{
	dir = 4
	},
/obj/effect/decal/cleanable/dirt,
/obj/machinery/door/firedoor/border_only{
	dir = 4
	},
/obj/machinery/door/firedoor/border_only{
	dir = 8
	},
/obj/structure/cable{
	icon_state = "4-8"
	},
/obj/machinery/door/airlock/mining/glass{
	name = "Cargo Bay"
	},
/turf/open/floor/pod/dark,
/area/ship/security/armory)
"LA" = (
/obj/structure/grille,
/turf/open/floor/plating/airless,
/area/ship/cargo)
"Nk" = (
/obj/machinery/power/smes/shuttle/precharged{
	dir = 1
	},
/obj/structure/cable{
	icon_state = "0-2"
	},
/obj/structure/window/plasma/reinforced/spawner,
/obj/machinery/door/window/eastright{
	dir = 1;
	name = "Engine Access"
	},
/turf/open/floor/plating,
/area/ship/crew/cryo)
"NL" = (
/obj/machinery/atmospherics/pipe/simple/supply/hidden{
	dir = 4
	},
/obj/effect/decal/cleanable/dirt,
/obj/structure/cable{
	icon_state = "4-8"
	},
/turf/open/floor/pod/dark,
/area/ship/security/armory)
"Oe" = (
/obj/machinery/atmospherics/pipe/manifold4w/supply/hidden,
/obj/structure/cable{
	icon_state = "2-4"
	},
/turf/open/floor/plasteel,
/area/ship/cargo)
"OD" = (
/obj/machinery/airalarm/all_access{
	pixel_y = 24
	},
/obj/machinery/cryopod,
/obj/machinery/computer/cryopod{
	pixel_x = 32
	},
/obj/structure/cable{
	icon_state = "2-8"
	},
/turf/open/floor/plasteel/dark,
/area/ship/crew/cryo)
"OL" = (
/obj/machinery/atmospherics/pipe/simple/supply/hidden,
/obj/effect/decal/cleanable/dirt,
/obj/structure/cable{
	icon_state = "1-2"
	},
/obj/structure/cable{
	icon_state = "2-8"
	},
/turf/open/floor/plasteel,
/area/ship/cargo)
"PX" = (
/obj/machinery/door/poddoor/shutters/preopen{
	id = "piratebridge"
	},
/obj/machinery/door/firedoor/border_only{
	dir = 1
	},
/obj/effect/spawner/structure/window/shuttle,
/turf/open/floor/plating,
/area/ship/cargo)
"Rt" = (
/obj/structure/window/reinforced{
	dir = 1;
	pixel_y = 1
	},
/obj/structure/frame/computer{
	anchored = 1
	},
/obj/effect/decal/cleanable/dirt,
/turf/open/floor/pod/dark,
/area/ship/medical)
"RY" = (
/obj/machinery/airalarm/all_access{
	pixel_y = 24
	},
/obj/effect/decal/cleanable/dirt,
/obj/structure/sign/poster/contraband/random{
	pixel_x = -32
	},
/obj/structure/cable{
	icon_state = "2-4"
	},
/turf/open/floor/wood,
/area/ship/cargo)
"Sb" = (
/obj/machinery/power/smes/shuttle/precharged{
	dir = 1
	},
/obj/structure/cable{
	icon_state = "0-2"
	},
/obj/structure/window/plasma/reinforced/spawner,
/obj/machinery/door/window/eastright{
	dir = 1;
	name = "Engine Access"
	},
/turf/open/floor/plating,
/area/ship/cargo)
"TG" = (
/obj/machinery/light{
	dir = 4
	},
/turf/open/floor/plasteel/white,
/area/ship/medical)
"Ur" = (
/obj/effect/decal/cleanable/dirt,
/obj/machinery/power/apc/auto_name/west,
/obj/structure/cable,
/obj/machinery/suit_storage_unit/ert/medical,
/turf/open/floor/plasteel/white,
/area/ship/medical)
"UD" = (
/obj/machinery/door/poddoor/shutters/preopen{
	id = "piratebridge"
	},
/obj/machinery/door/firedoor/border_only{
	dir = 1
	},
/obj/effect/spawner/structure/window/shuttle,
/turf/open/floor/plating,
/area/ship/medical)
"WJ" = (
/obj/machinery/light/small{
	dir = 1
	},
/obj/machinery/firealarm{
	pixel_y = 24
	},
/obj/effect/decal/cleanable/dirt,
/obj/machinery/vending/security/marine/solgov{
	all_items_free = 1
	},
/turf/open/floor/pod/light,
/area/ship/security/armory)
"Yj" = (
/obj/effect/decal/cleanable/dirt,
/obj/machinery/power/apc/auto_name/south,
/obj/structure/cable{
	icon_state = "0-4"
	},
/obj/structure/closet/crate,
/obj/item/stack/sheet/metal/fifty,
/obj/item/stack/sheet/glass/fifty,
/turf/open/floor/plasteel,
/area/ship/cargo)
"YD" = (
/obj/machinery/atmospherics/components/unary/vent_pump/on{
	dir = 8
	},
/turf/open/floor/plasteel/white,
/area/ship/medical)

(1,1,1) = {"
af
af
af
wR
aQ
aQ
aQ
FH
FH
FH
aQ
wR
af
af
af
af
"}
(2,1,1) = {"
af
LA
eu
ex
eA
aa
ap
aw
wP
bF
aQ
aQ
aQ
wR
af
af
"}
(3,1,1) = {"
aQ
aQ
aQ
aQ
aQ
aQ
aQ
ax
aq
Yj
aQ
RY
aM
Sb
aH
af
"}
(4,1,1) = {"
af
af
af
af
af
af
PX
ay
Oe
OL
zw
dy
br
Sb
aH
af
"}
(5,1,1) = {"
af
af
af
af
af
af
aQ
az
bx
bH
ah
ah
ah
ah
ah
aR
"}
(6,1,1) = {"
af
af
af
as
aP
aj
aj
dL
KQ
dL
ah
Gk
aD
aF
aI
aJ
"}
(7,1,1) = {"
af
af
as
aE
aC
aW
aj
bg
gY
JT
ah
km
aN
ah
ah
ah
"}
(8,1,1) = {"
af
af
at
ab
ae
bf
aj
bl
fY
ai
aU
be
aD
aG
jo
er
"}
(9,1,1) = {"
af
af
at
ac
ag
am
au
bm
by
bm
mU
aL
bP
bX
ep
aK
"}
(10,1,1) = {"
af
af
at
ad
ae
an
aj
WJ
NL
bI
ah
bO
bQ
bk
jo
er
"}
(11,1,1) = {"
af
af
aA
aE
al
aB
aj
ek
bA
vB
ah
np
aO
ah
ah
ah
"}
(12,1,1) = {"
af
af
af
aA
aT
aj
aj
dL
yi
dL
ah
lC
aS
bZ
bo
ce
"}
(13,1,1) = {"
af
af
af
af
af
af
Jr
mD
bB
Ur
ah
ah
ah
ah
ah
aR
"}
(14,1,1) = {"
af
af
af
af
af
af
UD
eE
bC
bJ
bM
dU
aV
Nk
wK
af
"}
(15,1,1) = {"
Jr
Jr
Jr
Jr
Jr
Jr
Jr
bu
YD
wf
GX
OD
no
Nk
wK
af
"}
(16,1,1) = {"
af
et
ew
ez
Rt
ao
av
bv
TG
bK
GX
GX
GX
df
af
af
"}
(17,1,1) = {"
af
af
af
fW
Jr
Jr
Jr
Jr
Jr
Jr
GX
df
af
af
af
af
"}
