//MAP CONVERTED BY dmm2tgm.py THIS HEADER COMMENT PREVENTS RECONVERSION, DO NOT REMOVE
"aH" = (
/obj/machinery/light{
	dir = 1
	},
/obj/machinery/atmospherics/pipe/simple/orange/hidden{
	dir = 8
	},
/obj/structure/cable{
	icon_state = "4-8"
	},
/obj/structure/closet/crate,
/obj/item/stack/sheet/metal/fifty,
/obj/item/stack/sheet/mineral/uranium/five,
/obj/item/stack/sheet/glass/fifty,
/turf/open/floor/plating,
/area/ship/engineering)
"aX" = (
/obj/effect/decal/cleanable/blood,
/obj/structure/cable{
	icon_state = "2-4"
	},
/turf/open/floor/mineral/plastitanium/red,
/area/ship/bridge)
"bp" = (
/obj/machinery/power/terminal{
	dir = 8
	},
/obj/structure/cable,
/turf/open/floor/plating,
/area/ship/engineering)
"cq" = (
/obj/effect/decal/cleanable/blood,
/turf/open/floor/plating,
/area/ship/engineering)
"df" = (
/obj/machinery/power/smes,
/obj/structure/cable{
	icon_state = "0-2"
	},
/turf/open/floor/plating,
/area/ship/engineering)
"dQ" = (
/obj/structure/window/reinforced/spawner,
/obj/machinery/power/smes/shuttle/precharged{
	dir = 1
	},
/obj/structure/cable{
	icon_state = "0-2"
	},
/turf/open/floor/plating,
/area/ship/engineering)
"ev" = (
/obj/structure/tank_dispenser,
/obj/machinery/light{
	dir = 1
	},
/turf/open/floor/mineral/plastitanium,
/area/ship/hallway/fore)
"fd" = (
/obj/machinery/mecha_part_fabricator,
/turf/open/floor/mineral/plastitanium,
/area/ship/science)
"ff" = (
/obj/effect/decal/cleanable/xenoblood,
/turf/open/floor/mineral/plastitanium,
/area/ship/science)
"gw" = (
/obj/machinery/suit_storage_unit/standard_unit,
/turf/open/floor/mineral/plastitanium,
/area/ship/hallway/fore)
"hi" = (
/obj/machinery/atmospherics/pipe/simple/orange/hidden,
/obj/structure/cable{
	icon_state = "4-8"
	},
/turf/open/floor/plating,
/area/ship/engineering)
"jE" = (
/turf/open/floor/mineral/plastitanium,
/area/ship/hallway/fore)
"kh" = (
/obj/machinery/door/airlock/hatch,
/turf/open/floor/mineral/plastitanium/red,
/area/ship/hallway/fore)
"kv" = (
/turf/closed/wall/mineral/plastitanium,
/area/ship/bridge)
"kA" = (
/obj/machinery/computer/autopilot,
/turf/open/floor/mineral/plastitanium/red,
/area/ship/bridge)
"lM" = (
/obj/structure/cable{
	icon_state = "4-8"
	},
/turf/open/floor/mineral/plastitanium/red,
/area/ship/hallway/fore)
"mE" = (
/obj/structure/cable{
	icon_state = "1-2"
	},
/obj/machinery/power/apc/auto_name/west,
/obj/structure/cable,
/obj/structure/reagent_dispensers/watertank,
/obj/structure/cable{
	icon_state = "1-4"
	},
/turf/open/floor/plating,
/area/ship/engineering)
"nn" = (
/obj/machinery/computer/nanite_chamber_control{
	dir = 8
	},
/turf/open/floor/mineral/plastitanium/red,
/area/ship/science)
"nA" = (
/obj/machinery/suit_storage_unit/standard_unit,
/obj/machinery/light{
	dir = 1
	},
/turf/open/floor/mineral/plastitanium,
/area/ship/hallway/fore)
"oC" = (
/obj/effect/decal/cleanable/blood,
/turf/open/floor/mineral/plastitanium,
/area/ship/science)
"oY" = (
/obj/effect/decal/cleanable/xenoblood,
/turf/open/floor/plating,
/area/ship/engineering)
"rT" = (
/turf/closed/wall/mineral/plastitanium,
/area/ship/hallway/fore)
"sC" = (
/obj/structure/cable{
	icon_state = "2-8"
	},
/turf/open/floor/mineral/plastitanium/red,
/area/ship/science)
"tm" = (
/turf/open/floor/plating,
/area/ship/engineering)
"tN" = (
/obj/structure/cable{
	icon_state = "4-8"
	},
/obj/machinery/door/airlock/hatch,
/turf/open/floor/mineral/plastitanium/red,
/area/ship/hallway/fore)
"vx" = (
/turf/open/floor/mineral/plastitanium/red,
/area/ship/science)
"wJ" = (
/obj/machinery/computer/helm,
/turf/open/floor/mineral/plastitanium/red,
/area/ship/bridge)
"xr" = (
/obj/effect/decal/cleanable/xenoblood,
/obj/structure/cable{
	icon_state = "1-8"
	},
/obj/structure/cable{
	icon_state = "4-8"
	},
/turf/open/floor/mineral/plastitanium/red,
/area/ship/hallway/fore)
"xN" = (
/obj/machinery/atmospherics/components/unary/shuttle/heater{
	dir = 1
	},
/obj/structure/window/reinforced/spawner,
/obj/structure/window/reinforced/spawner{
	dir = 8
	},
/turf/open/floor/plating,
/area/ship/engineering)
"xO" = (
/obj/docking_port/mobile{
	launch_status = 0;
	port_direction = 2
	},
/obj/structure/fans/tiny,
/obj/machinery/door/airlock/external,
/turf/open/floor/mineral/plastitanium/red,
/area/ship/hallway/fore)
"yF" = (
/obj/machinery/atmospherics/components/unary/shuttle/heater{
	dir = 1
	},
/obj/structure/window/reinforced/spawner,
/turf/open/floor/plating,
/area/ship/engineering)
"Ae" = (
/obj/structure/chair/comfy/shuttle{
	dir = 1
	},
/obj/machinery/light{
	dir = 4
	},
/obj/effect/decal/cleanable/xenoblood,
/obj/machinery/power/apc/auto_name/east,
/turf/open/floor/mineral/plastitanium/red,
/area/ship/bridge)
"Be" = (
/obj/machinery/atmospherics/pipe/simple/orange/hidden,
/turf/open/floor/plating,
/area/ship/engineering)
"Bl" = (
/obj/machinery/atmospherics/pipe/simple/orange/hidden{
	dir = 6
	},
/turf/open/floor/plating,
/area/ship/engineering)
"Bu" = (
/obj/machinery/light{
	dir = 1
	},
/obj/structure/cable{
	icon_state = "0-8"
	},
/obj/machinery/power/apc/auto_name/east,
/turf/open/floor/mineral/plastitanium,
/area/ship/hallway/fore)
"BR" = (
/obj/structure/cable{
	icon_state = "1-2"
	},
/obj/machinery/door/airlock/hatch,
/turf/open/floor/mineral/plastitanium/red,
/area/ship/bridge)
"Co" = (
/obj/structure/cable{
	icon_state = "1-2"
	},
/obj/item/storage/belt/utility/full,
/obj/structure/rack,
/obj/item/storage/toolbox/syndicate,
/turf/open/floor/plating,
/area/ship/engineering)
"Dy" = (
/obj/structure/rack,
/obj/item/storage/bag/ore,
/obj/item/storage/bag/ore,
/obj/item/pickaxe,
/obj/item/pickaxe,
/obj/item/mining_scanner,
/obj/item/mining_scanner,
/turf/open/floor/mineral/plastitanium,
/area/ship/hallway/fore)
"DV" = (
/obj/effect/decal/cleanable/blood,
/obj/structure/cable{
	icon_state = "1-2"
	},
/obj/structure/cable{
	icon_state = "2-4"
	},
/turf/open/floor/mineral/plastitanium/red,
/area/ship/hallway/fore)
"Eb" = (
/obj/structure/cable{
	icon_state = "1-2"
	},
/obj/structure/reagent_dispensers/fueltank,
/turf/open/floor/plating,
/area/ship/engineering)
"Es" = (
/obj/machinery/atmospherics/pipe/manifold/orange{
	dir = 4
	},
/turf/open/floor/plating,
/area/ship/engineering)
"Fd" = (
/obj/machinery/power/shuttle/engine/fueled/plasma{
	dir = 1
	},
/turf/open/floor/plating,
/area/ship/external)
"Ff" = (
/obj/machinery/nanite_programmer,
/turf/open/floor/mineral/plastitanium,
/area/ship/science)
"Fv" = (
/obj/machinery/light{
	dir = 1
	},
/obj/structure/table/reinforced,
/obj/item/mmi/posibrain,
/obj/item/storage/firstaid,
/obj/item/assembly/prox_sensor,
/obj/item/healthanalyzer,
/turf/open/floor/mineral/plastitanium,
/area/ship/science)
"FQ" = (
/obj/structure/cable{
	icon_state = "4-8"
	},
/turf/open/floor/plating,
/area/ship/engineering)
"Im" = (
/obj/structure/cable,
/obj/machinery/power/apc/auto_name/west,
/turf/open/floor/mineral/plastitanium,
/area/ship/science)
"Jh" = (
/obj/effect/decal/cleanable/blood,
/turf/open/floor/mineral/plastitanium/red,
/area/ship/science)
"Ki" = (
/obj/machinery/light{
	dir = 1
	},
/obj/machinery/cryopod{
	dir = 4
	},
/obj/machinery/computer/cryopod{
	pixel_y = 26
	},
/turf/open/floor/mineral/plastitanium,
/area/ship/hallway/fore)
"Ln" = (
/obj/machinery/atmospherics/pipe/simple/orange/hidden{
	dir = 10
	},
/obj/structure/cable{
	icon_state = "1-8"
	},
/turf/open/floor/plating,
/area/ship/engineering)
"LD" = (
/obj/machinery/nanite_program_hub,
/turf/open/floor/mineral/plastitanium,
/area/ship/science)
"Ma" = (
/turf/template_noop,
/area/template_noop)
"Ns" = (
/obj/machinery/atmospherics/components/unary/tank/toxins{
	dir = 4
	},
/obj/structure/cable{
	icon_state = "2-4"
	},
/turf/open/floor/plating,
/area/ship/engineering)
"NN" = (
/turf/open/floor/mineral/plastitanium,
/area/ship/science)
"NV" = (
/turf/closed/wall/mineral/plastitanium,
/area/ship/science)
"OH" = (
/obj/machinery/ore_silo,
/turf/open/floor/mineral/plastitanium,
/area/ship/science)
"PL" = (
/obj/machinery/atmospherics/components/binary/pump,
/obj/effect/decal/cleanable/blood,
/turf/open/floor/plating,
/area/ship/engineering)
"Qh" = (
/obj/machinery/power/port_gen/pacman/uranium,
/obj/structure/cable{
	icon_state = "0-2"
	},
/turf/open/floor/plating,
/area/ship/engineering)
"Qq" = (
/obj/machinery/power/terminal,
/obj/structure/cable{
	icon_state = "1-4"
	},
/obj/structure/cable,
/turf/open/floor/plating,
/area/ship/engineering)
"RN" = (
/obj/structure/window/plasma/reinforced/plastitanium,
/obj/structure/grille,
/turf/open/floor/plating,
/area/ship/bridge)
"RZ" = (
/turf/closed/wall/mineral/plastitanium,
/area/ship/engineering)
"Sa" = (
/obj/structure/cable{
	icon_state = "1-2"
	},
/turf/open/floor/mineral/plastitanium/red,
/area/ship/hallway/fore)
"Se" = (
/obj/machinery/nanite_chamber,
/turf/open/floor/mineral/plastitanium,
/area/ship/science)
"Uh" = (
/obj/machinery/power/shuttle/engine/electric{
	dir = 1
	},
/obj/structure/cable,
/turf/open/floor/plating,
/area/ship/external)
"UE" = (
/obj/effect/decal/cleanable/blood,
/turf/open/floor/mineral/plastitanium,
/area/ship/hallway/fore)
"UJ" = (
/obj/machinery/light,
/obj/structure/closet/crate,
/obj/item/circuitboard/machine/rdserver,
/obj/item/multitool,
/obj/item/stack/cable_coil/yellow,
/obj/item/stack/sheet/metal/five,
/turf/open/floor/mineral/plastitanium,
/area/ship/science)
"Vk" = (
/obj/item/nanite_remote,
/obj/item/storage/box/disks_nanite,
/obj/item/nanite_scanner,
/obj/structure/table/reinforced,
/turf/open/floor/mineral/plastitanium,
/area/ship/science)
"Wk" = (
/obj/structure/chair/comfy/shuttle{
	dir = 1
	},
/obj/machinery/light{
	dir = 8
	},
/turf/open/floor/mineral/plastitanium/red,
/area/ship/bridge)
"Wl" = (
/obj/structure/window/plasma/reinforced/plastitanium,
/obj/structure/grille,
/turf/open/floor/plating,
/area/ship/science)
"WA" = (
/obj/machinery/autolathe,
/turf/open/floor/mineral/plastitanium,
/area/ship/science)
"WM" = (
/obj/machinery/computer/nanite_cloud_controller,
/turf/open/floor/mineral/plastitanium,
/area/ship/science)
"XN" = (
/obj/machinery/power/terminal,
/obj/structure/cable{
	icon_state = "0-8"
	},
/turf/open/floor/plating,
/area/ship/engineering)
"Ys" = (
/turf/open/floor/mineral/plastitanium/red,
/area/ship/hallway/fore)
"YM" = (
/obj/effect/decal/cleanable/xenoblood,
/turf/open/floor/mineral/plastitanium/red,
/area/ship/hallway/fore)
"ZO" = (
/obj/structure/table/reinforced,
/obj/item/areaeditor/shuttle,
/turf/open/floor/mineral/plastitanium/red,
/area/ship/bridge)

(1,1,1) = {"
Ma
Ma
Ma
Ma
RZ
RZ
RZ
RZ
RZ
RZ
RZ
Ma
Ma
Ma
Ma
"}
(2,1,1) = {"
Ma
Ma
Ma
RZ
RZ
df
Co
mE
Eb
Qq
dQ
Uh
Ma
Ma
Ma
"}
(3,1,1) = {"
Ma
Ma
Ma
RZ
Ns
bp
tm
FQ
oY
XN
dQ
Uh
Ma
Ma
Ma
"}
(4,1,1) = {"
Ma
Ma
RZ
RZ
aH
cq
tm
FQ
tm
tm
Bl
xN
Fd
Ma
Ma
"}
(5,1,1) = {"
Ma
Ma
RZ
Qh
Ln
Be
Be
hi
Be
PL
Es
yF
Fd
Ma
Ma
"}
(6,1,1) = {"
Ma
kv
kv
kv
kv
rT
rT
tN
rT
rT
rT
rT
rT
rT
Ma
"}
(7,1,1) = {"
Ma
RN
wJ
Wk
kv
Ki
jE
lM
jE
Dy
rT
ev
gw
rT
Ma
"}
(8,1,1) = {"
Ma
RN
ZO
aX
BR
DV
Sa
xr
Ys
Ys
kh
YM
Ys
xO
Ma
"}
(9,1,1) = {"
Ma
RN
kA
Ae
kv
Bu
jE
lM
jE
UE
rT
nA
gw
rT
Ma
"}
(10,1,1) = {"
Ma
kv
kv
kv
kv
rT
rT
tN
rT
rT
rT
rT
rT
rT
Ma
"}
(11,1,1) = {"
Ma
Ma
NV
fd
NN
ff
NN
sC
Im
NN
oC
WA
NV
Ma
Ma
"}
(12,1,1) = {"
Ma
Ma
NV
NV
Fv
NN
NN
Jh
NN
NN
UJ
NV
NV
Ma
Ma
"}
(13,1,1) = {"
Ma
Ma
Ma
NV
Vk
NN
NN
vx
NN
ff
OH
NV
Ma
Ma
Ma
"}
(14,1,1) = {"
Ma
Ma
Ma
NV
NV
WM
LD
nn
Ff
Se
NV
NV
Ma
Ma
Ma
"}
(15,1,1) = {"
Ma
Ma
Ma
Ma
NV
NV
Wl
Wl
Wl
NV
NV
Ma
Ma
Ma
Ma
"}
