//MAP CONVERTED BY dmm2tgm.py THIS HEADER COMMENT PREVENTS RECONVERSION, DO NOT REMOVE
"ah" = (
/obj/structure/chair/comfy/brown,
/obj/structure/cable{
	icon_state = "1-4"
	},
/turf/open/floor/carpet,
/area/ship/bridge)
"aQ" = (
/obj/machinery/cryopod{
	dir = 1
	},
/obj/machinery/computer/cryopod{
	pixel_x = -32
	},
/turf/open/floor/mineral/gold,
/area/ship/bridge)
"cL" = (
/obj/structure/cable{
	icon_state = "4-8"
	},
/turf/open/floor/light/colour_cycle/dancefloor_b,
/area/ship/bridge)
"fs" = (
/obj/machinery/door/airlock/gold/glass,
/obj/structure/fans/tiny,
/turf/open/floor/wood,
/area/ship/bridge)
"ga" = (
/obj/structure/statue/plasma/scientist,
/obj/machinery/light{
	dir = 4
	},
/turf/open/floor/light/colour_cycle/dancefloor_b,
/area/ship/bridge)
"iW" = (
/obj/structure/chair/comfy/brown{
	dir = 8
	},
/turf/open/floor/mineral/gold,
/area/ship/bridge)
"kJ" = (
/obj/machinery/jukebox/disco,
/obj/structure/cable{
	icon_state = "2-4"
	},
/turf/open/floor/light/colour_cycle/dancefloor_a,
/area/ship/bridge)
"lA" = (
/obj/structure/cable{
	icon_state = "4-8"
	},
/turf/open/floor/light/colour_cycle/dancefloor_a,
/area/ship/bridge)
"lC" = (
/obj/machinery/computer{
	dir = 8;
	icon_keyboard = "ratvar_key1";
	name = "abandoned computer"
	},
/turf/open/floor/mineral/gold,
/area/ship/bridge)
"nX" = (
/obj/structure/cable{
	icon_state = "1-2"
	},
/turf/open/floor/mineral/plasma,
/area/ship/bridge)
"oq" = (
/obj/machinery/computer/slot_machine,
/turf/open/floor/wood,
/area/ship/bridge)
"oF" = (
/obj/machinery/atmospherics/components/binary/volume_pump{
	dir = 1
	},
/obj/machinery/light{
	dir = 4
	},
/obj/machinery/power/terminal{
	dir = 1
	},
/obj/structure/cable,
/obj/machinery/power/port_gen/pacman,
/obj/item/stack/sheet/mineral/plasma/five,
/obj/item/wrench,
/turf/open/floor/wood,
/area/ship/bridge)
"ql" = (
/obj/structure/chair/comfy/brown{
	dir = 1
	},
/turf/open/floor/mineral/gold,
/area/ship/bridge)
"qm" = (
/obj/machinery/door/airlock/gold/glass,
/obj/structure/fans/tiny,
/obj/docking_port/mobile{
	can_move_docking_ports = 1;
	dir = 4;
	dwidth = 5;
	height = 29;
	launch_status = 0;
	name = "disco inferno";
	port_direction = 2;
	width = 19
	},
/turf/open/floor/mineral/plasma,
/area/ship/bridge)
"rh" = (
/obj/structure/cable{
	icon_state = "4-8"
	},
/turf/open/floor/wood,
/area/ship/bridge)
"rJ" = (
/turf/open/floor/mineral/plasma,
/area/ship/bridge)
"se" = (
/obj/machinery/atmospherics/pipe/simple/orange{
	dir = 6
	},
/obj/structure/cable{
	icon_state = "4-8"
	},
/obj/machinery/autolathe,
/obj/item/stack/sheet/glass{
	amount = 5
	},
/obj/item/stack/sheet/metal/five,
/turf/open/floor/wood,
/area/ship/bridge)
"uR" = (
/obj/structure/cable{
	icon_state = "4-8"
	},
/turf/open/floor/mineral/gold,
/area/ship/bridge)
"vS" = (
/turf/open/floor/mineral/silver,
/area/ship/bridge)
"xk" = (
/turf/open/floor/light/colour_cycle/dancefloor_a,
/area/ship/bridge)
"yn" = (
/obj/structure/window/plasma/reinforced/fulltile,
/obj/structure/grille,
/turf/open/floor/plating,
/area/ship/bridge)
"yD" = (
/obj/structure/table/wood/poker,
/obj/item/toy/cards/deck,
/turf/open/floor/carpet,
/area/ship/bridge)
"yJ" = (
/obj/machinery/atmospherics/miner/toxins,
/obj/structure/window/plasma/reinforced{
	dir = 1
	},
/obj/structure/window/plasma/reinforced{
	dir = 8
	},
/obj/structure/window/plasma/reinforced{
	dir = 4
	},
/obj/structure/window/plasma/reinforced,
/obj/machinery/atmospherics/components/unary/passive_vent{
	dir = 1
	},
/turf/open/floor/engine/plasma,
/area/ship/bridge)
"zT" = (
/turf/open/floor/carpet,
/area/ship/bridge)
"AH" = (
/obj/machinery/atmospherics/pipe/simple/orange{
	dir = 10
	},
/obj/machinery/power/smes,
/obj/structure/cable{
	icon_state = "0-8"
	},
/turf/open/floor/wood,
/area/ship/bridge)
"AP" = (
/turf/open/floor/light/colour_cycle/dancefloor_b,
/area/ship/bridge)
"AZ" = (
/obj/structure/chair/comfy/brown{
	dir = 4
	},
/turf/open/floor/carpet,
/area/ship/bridge)
"Cu" = (
/obj/machinery/light{
	dir = 8
	},
/obj/machinery/computer/slot_machine,
/turf/open/floor/wood,
/area/ship/bridge)
"CB" = (
/obj/structure/cable{
	icon_state = "1-2"
	},
/turf/open/floor/light/colour_cycle/dancefloor_a,
/area/ship/bridge)
"CO" = (
/obj/structure/chair/comfy/brown{
	dir = 1
	},
/obj/machinery/atmospherics/pipe/manifold/orange{
	dir = 1
	},
/turf/open/floor/carpet,
/area/ship/bridge)
"Eb" = (
/obj/structure/cable{
	icon_state = "1-2"
	},
/turf/open/floor/mineral/gold,
/area/ship/bridge)
"Gp" = (
/obj/machinery/computer{
	dir = 4;
	icon_keyboard = "ratvar_key1";
	name = "abandoned computer"
	},
/turf/open/floor/mineral/gold,
/area/ship/bridge)
"GV" = (
/obj/structure/chair/comfy/brown{
	dir = 8
	},
/turf/open/floor/carpet,
/area/ship/bridge)
"GY" = (
/obj/structure/cable{
	icon_state = "0-8"
	},
/obj/machinery/power/apc/auto_name/east,
/turf/open/floor/mineral/gold,
/area/ship/bridge)
"Hr" = (
/obj/machinery/atmospherics/pipe/manifold/orange{
	dir = 4
	},
/obj/structure/closet/crate/wooden,
/obj/item/pickaxe,
/obj/item/pickaxe,
/obj/item/pickaxe,
/obj/item/storage/bag/ore,
/obj/item/storage/bag/ore,
/obj/item/storage/bag/ore,
/obj/item/t_scanner/adv_mining_scanner/lesser,
/obj/item/t_scanner/adv_mining_scanner/lesser,
/obj/item/t_scanner/adv_mining_scanner/lesser,
/turf/open/floor/wood,
/area/ship/bridge)
"HT" = (
/obj/machinery/atmospherics/pipe/manifold/orange{
	dir = 1
	},
/turf/open/floor/carpet,
/area/ship/bridge)
"Iz" = (
/turf/closed/wall/mineral/plastitanium,
/area/ship/bridge)
"IW" = (
/obj/structure/cable{
	icon_state = "1-2"
	},
/turf/open/floor/light/colour_cycle/dancefloor_b,
/area/ship/bridge)
"Ju" = (
/obj/machinery/atmospherics/pipe/manifold/orange{
	dir = 1
	},
/turf/open/floor/wood,
/area/ship/bridge)
"Ko" = (
/obj/machinery/computer/helm,
/turf/open/floor/mineral/gold,
/area/ship/bridge)
"Kt" = (
/obj/structure/table/wood,
/obj/item/areaeditor/shuttle,
/obj/item/multitool,
/turf/open/floor/mineral/gold,
/area/ship/bridge)
"LW" = (
/obj/structure/chair/comfy/brown{
	dir = 8
	},
/turf/open/floor/wood,
/area/ship/bridge)
"Nt" = (
/obj/machinery/light{
	dir = 8
	},
/obj/machinery/computer{
	dir = 4;
	icon_keyboard = "ratvar_key1";
	name = "abandoned computer"
	},
/turf/open/floor/mineral/gold,
/area/ship/bridge)
"PK" = (
/obj/structure/cable{
	icon_state = "4-8"
	},
/turf/open/floor/carpet,
/area/ship/bridge)
"Qc" = (
/obj/structure/window/plasma/reinforced{
	dir = 1
	},
/obj/machinery/atmospherics/components/unary/shuttle/heater{
	dir = 1
	},
/turf/open/floor/plating,
/area/ship/bridge)
"Qh" = (
/obj/structure/chair/comfy/brown{
	dir = 8
	},
/obj/machinery/atmospherics/pipe/simple/orange{
	dir = 6
	},
/turf/open/floor/wood,
/area/ship/bridge)
"SR" = (
/obj/machinery/door/airlock/gold/glass,
/turf/open/floor/mineral/gold,
/area/ship/bridge)
"TU" = (
/obj/structure/chair/comfy/brown{
	dir = 4
	},
/obj/structure/fireaxecabinet{
	pixel_x = 32;
	pixel_y = 32
	},
/turf/open/floor/mineral/gold,
/area/ship/bridge)
"Uj" = (
/turf/open/floor/mineral/gold,
/area/ship/bridge)
"Vj" = (
/obj/structure/chair/comfy/brown{
	dir = 4
	},
/turf/open/floor/mineral/gold,
/area/ship/bridge)
"Vs" = (
/obj/structure/statue/plasma/scientist,
/obj/machinery/light{
	dir = 8
	},
/turf/open/floor/light/colour_cycle/dancefloor_b,
/area/ship/bridge)
"Vw" = (
/obj/machinery/light{
	dir = 4
	},
/obj/machinery/computer{
	dir = 8;
	icon_keyboard = "ratvar_key1";
	name = "abandoned computer"
	},
/turf/open/floor/mineral/gold,
/area/ship/bridge)
"VV" = (
/obj/machinery/power/shuttle/engine/fueled/plasma{
	dir = 1
	},
/turf/open/floor/plating,
/area/ship/bridge)
"Xr" = (
/obj/structure/window/plasma/reinforced/fulltile,
/obj/structure/grille,
/obj/structure/cable{
	icon_state = "1-2"
	},
/turf/open/floor/plating,
/area/ship/bridge)
"Yn" = (
/turf/open/floor/wood,
/area/ship/bridge)
"YO" = (
/turf/template_noop,
/area/template_noop)
"YQ" = (
/obj/machinery/atmospherics/pipe/simple/orange,
/turf/open/floor/wood,
/area/ship/bridge)

(1,1,1) = {"
YO
YO
YO
YO
Iz
Iz
Iz
yn
Iz
qm
Iz
yn
yn
yn
Iz
Iz
Iz
fs
Iz
yn
Iz
YO
"}
(2,1,1) = {"
YO
Iz
Iz
Iz
Iz
Vs
rJ
rJ
rJ
rJ
Uj
rJ
rJ
rJ
rJ
Vs
yn
Yn
Cu
oq
Iz
Iz
"}
(3,1,1) = {"
Iz
Iz
Nt
Gp
yn
rJ
rJ
rJ
rJ
vS
Uj
vS
rJ
rJ
rJ
rJ
yn
Yn
LW
Qh
Qc
VV
"}
(4,1,1) = {"
yn
aQ
iW
iW
yn
rJ
rJ
rJ
Uj
Uj
xk
Uj
Uj
rJ
rJ
rJ
yn
Yn
Yn
Ju
Qc
VV
"}
(5,1,1) = {"
yn
ql
Uj
Uj
yn
rJ
rJ
vS
Uj
xk
AP
xk
Uj
vS
rJ
rJ
yn
zT
AZ
HT
Qc
VV
"}
(6,1,1) = {"
yn
Ko
Uj
Uj
yn
rJ
Uj
Uj
xk
AP
kJ
IW
CB
Eb
Eb
nX
Xr
ah
yD
CO
Qc
VV
"}
(7,1,1) = {"
yn
ql
Uj
Uj
SR
rJ
rJ
vS
Uj
xk
cL
xk
Uj
vS
rJ
rJ
yn
PK
GV
HT
Qc
VV
"}
(8,1,1) = {"
yn
Kt
TU
Vj
yn
rJ
rJ
rJ
Uj
Uj
lA
Uj
Uj
rJ
rJ
rJ
yn
rh
Yn
Ju
Qc
VV
"}
(9,1,1) = {"
Iz
Iz
Vw
lC
yn
rJ
rJ
rJ
rJ
vS
uR
vS
rJ
rJ
rJ
rJ
yn
se
YQ
Hr
Qc
VV
"}
(10,1,1) = {"
YO
Iz
Iz
Iz
Iz
ga
rJ
rJ
rJ
rJ
GY
rJ
rJ
rJ
rJ
ga
yn
AH
oF
yJ
Iz
Iz
"}
(11,1,1) = {"
YO
YO
YO
YO
Iz
Iz
Iz
yn
Iz
Iz
Iz
yn
yn
yn
Iz
Iz
Iz
yn
Iz
yn
Iz
YO
"}
