//MAP CONVERTED BY dmm2tgm.py THIS HEADER COMMENT PREVENTS RECONVERSION, DO NOT REMOVE
"al" = (
/obj/machinery/power/apc/auto_name/north,
/obj/structure/cable{
	icon_state = "0-2"
	},
/turf/open/floor/plating,
/area/ship/engineering)
"as" = (
/obj/effect/decal/cleanable/xenoblood,
/turf/open/floor/plating,
/area/ship/cargo)
"az" = (
/obj/structure/girder,
/obj/structure/grille,
/obj/structure/cable{
	icon_state = "0-2"
	},
/obj/structure/cable{
	icon_state = "1-2"
	},
/turf/open/floor/plating,
/area/ship/maintenance/central)
"aA" = (
/obj/structure/cable{
	icon_state = "4-8"
	},
/turf/open/floor/plating,
/area/ship/maintenance/central)
"aO" = (
/turf/open/floor/plating,
/area/ship/science)
"aY" = (
/obj/machinery/power/apc/auto_name/east,
/obj/structure/cable{
	icon_state = "0-8"
	},
/turf/open/floor/plating,
/area/ship/medical)
"bV" = (
/obj/structure/cable{
	icon_state = "4-8"
	},
/obj/machinery/door/airlock/maintenance_hatch,
/turf/open/floor/plating,
/area/ship/crew/janitor)
"cH" = (
/obj/structure/cable{
	icon_state = "1-8"
	},
/obj/structure/cable{
	icon_state = "1-4"
	},
/obj/machinery/atmospherics/components/binary/volume_pump{
	dir = 4
	},
/turf/open/floor/plating,
/area/ship/engineering)
"dh" = (
/obj/structure/cable{
	icon_state = "2-8"
	},
/turf/open/floor/plating,
/area/ship/crew/dorm)
"dC" = (
/obj/structure/cable{
	icon_state = "4-8"
	},
/obj/machinery/door/airlock/maintenance_hatch,
/obj/effect/decal/cleanable/oil/slippery,
/turf/open/floor/plating,
/area/ship/maintenance/central)
"dK" = (
/obj/structure/cable{
	icon_state = "1-2"
	},
/obj/structure/cable{
	icon_state = "4-8"
	},
/turf/open/floor/plating,
/area/ship/engineering)
"dO" = (
/obj/structure/girder,
/obj/structure/grille,
/obj/structure/cable,
/obj/structure/cable{
	icon_state = "1-2"
	},
/turf/open/floor/plating,
/area/ship/maintenance/central)
"dS" = (
/obj/structure/cable{
	icon_state = "1-4"
	},
/obj/structure/cable{
	icon_state = "1-8"
	},
/turf/open/floor/plating,
/area/ship/maintenance/central)
"ef" = (
/obj/structure/cable{
	icon_state = "2-4"
	},
/obj/effect/decal/cleanable/blood,
/turf/open/floor/plating,
/area/ship/engineering)
"es" = (
/obj/structure/cable{
	icon_state = "2-4"
	},
/obj/effect/decal/cleanable/blood,
/turf/open/floor/plating,
/area/ship/science)
"eM" = (
/turf/closed/wall,
/area/ship/crew/dorm)
"eO" = (
/obj/structure/cable{
	icon_state = "4-8"
	},
/turf/open/floor/plating,
/area/ship/science)
"fL" = (
/obj/effect/mob_spawn/human/corpse/assistant,
/obj/effect/decal/cleanable/blood,
/turf/open/floor/plating,
/area/ship/science)
"fP" = (
/obj/structure/girder,
/obj/structure/grille,
/turf/open/floor/plating,
/area/ship/maintenance/central)
"fQ" = (
/obj/machinery/door/airlock/maintenance_hatch,
/obj/effect/decal/cleanable/oil/slippery,
/turf/open/floor/plating,
/area/ship/maintenance/central)
"gh" = (
/obj/machinery/power/terminal,
/obj/structure/cable{
	icon_state = "0-4"
	},
/turf/open/floor/plating,
/area/ship/engineering)
"gj" = (
/obj/structure/cable{
	icon_state = "4-8"
	},
/turf/open/floor/plating,
/area/ship/engineering)
"gq" = (
/obj/structure/cable{
	icon_state = "4-8"
	},
/turf/open/floor/plating,
/area/ship/bridge)
"hl" = (
/obj/effect/decal/cleanable/oil/slippery,
/turf/open/floor/plating,
/area/ship/cargo)
"hz" = (
/obj/structure/cable{
	icon_state = "1-4"
	},
/obj/effect/spawner/lootdrop/maintenance,
/turf/open/floor/plating,
/area/ship/maintenance/central)
"hQ" = (
/obj/structure/cable{
	icon_state = "1-8"
	},
/obj/structure/cable{
	icon_state = "1-4"
	},
/turf/open/floor/plating,
/area/ship/maintenance/central)
"hS" = (
/obj/machinery/door/airlock/maintenance_hatch,
/turf/open/floor/plating,
/area/ship/engineering)
"hT" = (
/turf/closed/wall,
/area/ship/crew/janitor)
"im" = (
/turf/closed/wall,
/area/ship/engineering)
"is" = (
/obj/structure/rack,
/obj/item/flashlight/flare,
/obj/item/flashlight/flare,
/obj/item/flashlight/flare,
/obj/item/flashlight/flare,
/obj/item/flashlight/flare,
/obj/item/flashlight/flare,
/obj/item/flashlight/flare,
/obj/item/flashlight/flare,
/obj/item/flashlight/flare,
/obj/item/flashlight/flare,
/obj/structure/cable{
	icon_state = "1-8"
	},
/turf/open/floor/plating,
/area/ship/crew/dorm)
"iz" = (
/obj/structure/cable{
	icon_state = "2-4"
	},
/obj/structure/cable{
	icon_state = "1-4"
	},
/obj/effect/decal/cleanable/oil/slippery,
/turf/open/floor/plating,
/area/ship/maintenance/central)
"iD" = (
/obj/effect/spawner/lootdrop/maintenance,
/turf/open/floor/plating,
/area/ship/science)
"iJ" = (
/obj/effect/spawner/lootdrop/maintenance,
/obj/structure/closet,
/obj/effect/spawner/lootdrop/maintenance/three,
/turf/open/floor/plating,
/area/ship/maintenance/central)
"iO" = (
/obj/structure/cable{
	icon_state = "2-8"
	},
/turf/open/floor/plating,
/area/ship/engineering)
"iR" = (
/obj/structure/cable{
	icon_state = "4-8"
	},
/obj/effect/decal/cleanable/oil/slippery,
/turf/open/floor/plating,
/area/ship/maintenance/central)
"jg" = (
/obj/structure/cable{
	icon_state = "4-8"
	},
/obj/machinery/door/airlock/maintenance_hatch,
/turf/open/floor/plating,
/area/ship/science)
"jH" = (
/obj/structure/cable{
	icon_state = "1-4"
	},
/obj/structure/cable{
	icon_state = "4-8"
	},
/turf/open/floor/plating,
/area/ship/engineering)
"jR" = (
/turf/closed/wall,
/area/ship/bridge)
"jW" = (
/obj/effect/decal/cleanable/blood,
/turf/open/floor/plating,
/area/ship/maintenance/central)
"km" = (
/obj/machinery/power/terminal,
/obj/structure/cable,
/obj/structure/cable{
	icon_state = "1-8"
	},
/obj/structure/cable{
	icon_state = "1-4"
	},
/turf/open/floor/plating,
/area/ship/engineering)
"ku" = (
/obj/structure/cable{
	icon_state = "2-4"
	},
/obj/structure/cable{
	icon_state = "2-8"
	},
/turf/open/floor/plating,
/area/ship/maintenance/central)
"kB" = (
/obj/structure/girder,
/obj/structure/grille,
/obj/structure/cable{
	icon_state = "0-8"
	},
/turf/open/floor/plating,
/area/ship/maintenance/central)
"kT" = (
/obj/structure/closet/crate/secure/loot,
/obj/item/research_notes/loot/genius,
/obj/effect/spawner/lootdrop/gloves,
/obj/effect/spawner/lootdrop/armory_contraband,
/obj/item/circuitboard/machine/ore_redemption,
/turf/open/floor/plating,
/area/ship/maintenance/central)
"la" = (
/obj/effect/mob_spawn/human/corpse/assistant,
/obj/effect/decal/cleanable/blood,
/turf/open/floor/plating,
/area/ship/maintenance/central)
"lf" = (
/obj/machinery/computer/helm,
/turf/open/floor/plating,
/area/ship/bridge)
"lo" = (
/obj/machinery/power/apc/auto_name/west,
/obj/structure/cable{
	icon_state = "0-4"
	},
/turf/open/floor/plating,
/area/ship/crew/dorm)
"lN" = (
/obj/machinery/power/shuttle/engine/fueled/plasma{
	dir = 1
	},
/obj/structure/window/reinforced{
	dir = 1
	},
/turf/open/floor/plating,
/area/ship/external)
"mb" = (
/obj/machinery/power/terminal,
/obj/structure/cable{
	icon_state = "4-8"
	},
/obj/structure/cable{
	icon_state = "0-4"
	},
/turf/open/floor/plating,
/area/ship/engineering)
"mc" = (
/obj/structure/cable{
	icon_state = "2-4"
	},
/turf/open/floor/plating,
/area/ship/cargo)
"mh" = (
/obj/machinery/power/smes,
/obj/structure/cable,
/turf/open/floor/plating,
/area/ship/engineering)
"ms" = (
/obj/structure/cable{
	icon_state = "4-8"
	},
/obj/machinery/door/airlock/maintenance_hatch,
/turf/open/floor/plating,
/area/ship/medical)
"nB" = (
/obj/structure/cable{
	icon_state = "4-8"
	},
/obj/structure/cable{
	icon_state = "2-4"
	},
/turf/open/floor/plating,
/area/ship/bridge)
"nC" = (
/obj/structure/cable{
	icon_state = "1-4"
	},
/obj/effect/decal/cleanable/blood,
/turf/open/floor/plating,
/area/ship/crew/dorm)
"nE" = (
/obj/structure/cable{
	icon_state = "2-8"
	},
/obj/structure/closet/emcloset,
/turf/open/floor/plating,
/area/ship/maintenance/central)
"nP" = (
/obj/effect/mob_spawn/human/corpse/assistant,
/turf/open/floor/plating,
/area/ship/maintenance/central)
"oF" = (
/obj/structure/cable{
	icon_state = "2-4"
	},
/turf/open/floor/plating,
/area/ship/maintenance/central)
"oU" = (
/obj/structure/closet,
/obj/effect/spawner/lootdrop/maintenance/three,
/obj/effect/decal/cleanable/blood,
/turf/open/floor/plating,
/area/ship/maintenance/central)
"pq" = (
/obj/structure/reagent_dispensers/fueltank,
/turf/open/floor/plating,
/area/ship/maintenance/central)
"pB" = (
/obj/effect/spawner/lootdrop/maintenance,
/turf/open/floor/plating,
/area/ship/maintenance/central)
"pM" = (
/turf/open/floor/plating,
/area/ship/crew/dorm)
"qd" = (
/obj/structure/rack,
/obj/item/storage/toolbox/mechanical,
/turf/open/floor/plating,
/area/ship/engineering)
"qj" = (
/obj/machinery/computer/operating,
/turf/open/floor/plating,
/area/ship/medical)
"qF" = (
/turf/open/floor/plating,
/area/ship/engineering)
"qP" = (
/obj/structure/reagent_dispensers/watertank,
/turf/open/floor/plating,
/area/ship/crew/janitor)
"qQ" = (
/obj/structure/fans/tiny,
/obj/machinery/door/poddoor{
	id = "portloadingbay";
	name = "Port Loading Bay"
	},
/turf/open/floor/plating,
/area/ship/cargo)
"rn" = (
/obj/structure/cable{
	icon_state = "2-8"
	},
/obj/effect/decal/cleanable/xenoblood,
/turf/open/floor/plating,
/area/ship/maintenance/central)
"rz" = (
/obj/machinery/atmospherics/components/unary/tank/toxins{
	dir = 1
	},
/turf/open/floor/plating,
/area/ship/engineering)
"rW" = (
/obj/machinery/cryopod{
	dir = 8
	},
/obj/machinery/computer/cryopod{
	pixel_x = 32
	},
/turf/open/floor/plating,
/area/ship/crew/dorm)
"sx" = (
/obj/structure/cable{
	icon_state = "1-2"
	},
/obj/structure/cable{
	icon_state = "2-8"
	},
/turf/open/floor/plating,
/area/ship/maintenance/central)
"sz" = (
/obj/structure/cable{
	icon_state = "1-2"
	},
/obj/effect/decal/cleanable/oil/slippery,
/turf/open/floor/plating,
/area/ship/maintenance/central)
"sB" = (
/obj/structure/cable{
	icon_state = "4-8"
	},
/obj/machinery/door/airlock/maintenance_hatch,
/turf/open/floor/plating,
/area/ship/bridge)
"sR" = (
/obj/structure/cable{
	icon_state = "1-2"
	},
/obj/machinery/door/airlock/maintenance_hatch,
/turf/open/floor/plating,
/area/ship/maintenance/central)
"tQ" = (
/obj/effect/decal/cleanable/oil/slippery,
/turf/open/floor/plating,
/area/ship/maintenance/central)
"tV" = (
/obj/structure/cable{
	icon_state = "4-8"
	},
/obj/machinery/atmospherics/pipe/manifold/purple/visible{
	dir = 1
	},
/turf/open/floor/plating,
/area/ship/engineering)
"tY" = (
/obj/structure/closet/emcloset,
/turf/open/floor/plating,
/area/ship/maintenance/central)
"uq" = (
/obj/machinery/power/smes,
/obj/structure/cable{
	icon_state = "0-2"
	},
/obj/structure/cable{
	icon_state = "0-8"
	},
/turf/open/floor/plating,
/area/ship/engineering)
"ux" = (
/obj/effect/decal/cleanable/blood,
/turf/open/floor/plating,
/area/ship/bridge)
"uM" = (
/obj/structure/closet/crate,
/obj/item/stack/sheet/metal/fifty,
/obj/item/stack/sheet/glass/fifty,
/obj/item/stack/sheet/mineral/plasma/twenty,
/turf/open/floor/plating,
/area/ship/cargo)
"uN" = (
/obj/machinery/atmospherics/components/unary/shuttle/heater{
	dir = 1
	},
/turf/open/floor/plating,
/area/ship/engineering)
"vE" = (
/obj/structure/rack,
/obj/item/pickaxe,
/obj/item/pickaxe,
/obj/item/pickaxe,
/obj/item/storage/bag/ore,
/obj/item/storage/bag/ore,
/obj/item/storage/bag/ore,
/obj/item/mining_scanner,
/obj/item/mining_scanner,
/obj/item/mining_scanner,
/turf/open/floor/plating,
/area/ship/cargo)
"vI" = (
/obj/structure/cable{
	icon_state = "4-8"
	},
/obj/structure/cable{
	icon_state = "1-4"
	},
/obj/structure/cable{
	icon_state = "2-4"
	},
/turf/open/floor/plating,
/area/ship/maintenance/central)
"wB" = (
/obj/structure/cable{
	icon_state = "1-4"
	},
/obj/effect/spawner/lootdrop/maintenance,
/obj/structure/closet,
/obj/effect/spawner/lootdrop/maintenance/three,
/turf/open/floor/plating,
/area/ship/maintenance/central)
"wL" = (
/obj/structure/cable{
	icon_state = "1-2"
	},
/obj/effect/decal/cleanable/blood,
/turf/open/floor/plating,
/area/ship/maintenance/central)
"xd" = (
/obj/structure/cable{
	icon_state = "2-8"
	},
/obj/structure/cable{
	icon_state = "1-8"
	},
/turf/open/floor/plating,
/area/ship/maintenance/central)
"xt" = (
/obj/structure/cable{
	icon_state = "2-4"
	},
/obj/structure/cable{
	icon_state = "1-4"
	},
/turf/open/floor/plating,
/area/ship/maintenance/central)
"yH" = (
/obj/structure/cable{
	icon_state = "1-4"
	},
/obj/machinery/atmospherics/components/binary/volume_pump{
	dir = 8
	},
/turf/open/floor/plating,
/area/ship/engineering)
"yX" = (
/obj/structure/cable{
	icon_state = "2-8"
	},
/obj/structure/cable{
	icon_state = "1-2"
	},
/turf/open/floor/plating,
/area/ship/maintenance/central)
"zr" = (
/obj/effect/decal/cleanable/xenoblood,
/turf/open/floor/plating,
/area/ship/maintenance/central)
"zv" = (
/turf/closed/wall,
/area/ship/medical)
"zF" = (
/obj/machinery/power/apc/auto_name/east,
/obj/structure/cable{
	icon_state = "0-8"
	},
/turf/open/floor/plating,
/area/ship/crew/janitor)
"zG" = (
/obj/structure/fans/tiny,
/obj/machinery/door/airlock/external,
/obj/effect/decal/cleanable/oil/slippery,
/turf/open/floor/plating,
/area/ship/maintenance/central)
"Ak" = (
/obj/structure/cable{
	icon_state = "2-8"
	},
/obj/effect/spawner/lootdrop/maintenance,
/turf/open/floor/plating,
/area/ship/maintenance/central)
"Ao" = (
/obj/machinery/door/airlock/maintenance_hatch,
/turf/open/floor/plating,
/area/ship/maintenance/central)
"As" = (
/obj/structure/cable{
	icon_state = "1-2"
	},
/obj/machinery/door/airlock/maintenance_hatch,
/turf/open/floor/plating,
/area/ship/science)
"AR" = (
/obj/machinery/power/apc/auto_name/west,
/obj/structure/cable{
	icon_state = "0-4"
	},
/obj/effect/decal/cleanable/blood,
/turf/open/floor/plating,
/area/ship/engineering)
"AS" = (
/obj/structure/cable{
	icon_state = "2-4"
	},
/turf/open/floor/plating,
/area/ship/science)
"AV" = (
/obj/machinery/atmospherics/pipe/simple/purple/visible{
	dir = 6
	},
/turf/open/floor/plating,
/area/ship/engineering)
"AW" = (
/obj/machinery/vending/medical,
/turf/open/floor/plating,
/area/ship/medical)
"BQ" = (
/obj/machinery/power/port_gen/pacman{
	anchored = 1
	},
/obj/structure/cable,
/turf/open/floor/plating,
/area/ship/engineering)
"Cg" = (
/obj/structure/cable{
	icon_state = "1-8"
	},
/obj/structure/closet/emcloset,
/turf/open/floor/plating,
/area/ship/maintenance/central)
"Cu" = (
/obj/structure/girder,
/obj/structure/grille,
/obj/structure/cable{
	icon_state = "1-2"
	},
/obj/structure/cable,
/obj/effect/decal/cleanable/oil/slippery,
/turf/open/floor/plating,
/area/ship/maintenance/central)
"CI" = (
/obj/structure/girder,
/obj/structure/grille,
/obj/structure/cable,
/turf/open/floor/plating,
/area/ship/maintenance/central)
"CY" = (
/obj/structure/cable{
	icon_state = "2-8"
	},
/obj/structure/cable{
	icon_state = "2-4"
	},
/turf/open/floor/plating,
/area/ship/maintenance/central)
"Dr" = (
/obj/structure/girder,
/obj/structure/grille,
/obj/structure/cable{
	icon_state = "0-2"
	},
/turf/open/floor/plating,
/area/ship/maintenance/central)
"El" = (
/obj/structure/cable{
	icon_state = "4-8"
	},
/obj/effect/decal/cleanable/xenoblood,
/turf/open/floor/plating,
/area/ship/maintenance/central)
"Em" = (
/obj/structure/cable{
	icon_state = "1-2"
	},
/obj/structure/cable{
	icon_state = "1-4"
	},
/turf/open/floor/plating,
/area/ship/maintenance/central)
"Ew" = (
/obj/structure/cable{
	icon_state = "2-8"
	},
/turf/open/floor/plating,
/area/ship/cargo)
"EX" = (
/obj/docking_port/mobile{
	dir = 2;
	launch_status = 0;
	port_direction = 8
	},
/turf/closed/wall,
/area/ship/maintenance/central)
"Fo" = (
/obj/effect/spawner/lootdrop/donkpockets,
/obj/effect/spawner/lootdrop/donkpockets,
/obj/effect/spawner/lootdrop/donkpockets,
/obj/structure/table/reinforced,
/turf/open/floor/plating,
/area/ship/maintenance/central)
"Fw" = (
/obj/structure/girder,
/obj/structure/grille,
/obj/structure/cable{
	icon_state = "0-8"
	},
/obj/structure/cable{
	icon_state = "4-8"
	},
/turf/open/floor/plating,
/area/ship/maintenance/central)
"Gf" = (
/obj/structure/chair/comfy/shuttle{
	dir = 1;
	name = "Helm"
	},
/obj/structure/cable{
	icon_state = "4-8"
	},
/turf/open/floor/plating,
/area/ship/bridge)
"Gl" = (
/obj/machinery/autolathe,
/turf/open/floor/plating,
/area/ship/science)
"GB" = (
/obj/structure/table/glass,
/obj/item/storage/firstaid/medical,
/turf/open/floor/plating,
/area/ship/medical)
"GV" = (
/obj/structure/closet,
/turf/open/floor/plating,
/area/ship/maintenance/central)
"Hh" = (
/obj/structure/cable{
	icon_state = "1-8"
	},
/turf/open/floor/plating,
/area/ship/cargo)
"Hi" = (
/obj/machinery/power/port_gen/pacman{
	anchored = 1
	},
/obj/machinery/power/terminal{
	dir = 4
	},
/obj/structure/cable{
	icon_state = "0-4"
	},
/turf/open/floor/plating,
/area/ship/engineering)
"HM" = (
/obj/structure/cable{
	icon_state = "2-8"
	},
/turf/open/floor/plating,
/area/ship/maintenance/central)
"HW" = (
/obj/structure/cable{
	icon_state = "1-2"
	},
/obj/effect/spawner/lootdrop/maintenance,
/turf/open/floor/plating,
/area/ship/maintenance/central)
"IT" = (
/obj/structure/cable{
	icon_state = "4-8"
	},
/obj/structure/cable{
	icon_state = "1-4"
	},
/turf/open/floor/plating,
/area/ship/maintenance/central)
"IW" = (
/obj/machinery/power/terminal{
	dir = 8
	},
/obj/structure/cable{
	icon_state = "0-2"
	},
/turf/open/floor/plating,
/area/ship/engineering)
"Ji" = (
/obj/machinery/suit_storage_unit/independent/mining/eva,
/turf/open/floor/plating,
/area/ship/bridge)
"JV" = (
/obj/structure/table/optable,
/turf/open/floor/plating,
/area/ship/medical)
"Kr" = (
/obj/structure/cable{
	icon_state = "4-8"
	},
/obj/machinery/door/airlock/maintenance_hatch,
/obj/effect/decal/cleanable/oil/slippery,
/turf/open/floor/plating,
/area/ship/bridge)
"Lc" = (
/obj/effect/spawner/lootdrop/crate_spawner,
/turf/open/floor/plating,
/area/ship/maintenance/central)
"LC" = (
/turf/closed/wall,
/area/ship/maintenance/central)
"LX" = (
/obj/structure/cable{
	icon_state = "1-2"
	},
/obj/machinery/door/airlock/maintenance_hatch,
/turf/open/floor/plating,
/area/ship/engineering)
"Mp" = (
/turf/open/floor/plating,
/area/ship/maintenance/central)
"Mw" = (
/obj/machinery/suit_storage_unit/mining,
/turf/open/floor/plating,
/area/ship/cargo)
"MI" = (
/obj/structure/cable{
	icon_state = "1-2"
	},
/turf/open/floor/plating,
/area/ship/science)
"ML" = (
/obj/structure/cable{
	icon_state = "1-2"
	},
/turf/open/floor/plating,
/area/ship/maintenance/central)
"Nd" = (
/obj/structure/table,
/obj/item/areaeditor/blueprints,
/turf/open/floor/plating,
/area/ship/bridge)
"No" = (
/obj/structure/cable{
	icon_state = "2-4"
	},
/obj/effect/decal/cleanable/oil/slippery,
/turf/open/floor/plating,
/area/ship/maintenance/central)
"NP" = (
/obj/structure/rack,
/obj/item/clothing/gloves/color/fyellow,
/turf/open/floor/plating,
/area/ship/engineering)
"NY" = (
/obj/effect/decal/cleanable/blood,
/turf/open/floor/plating,
/area/ship/cargo)
"Oo" = (
/obj/structure/closet,
/obj/effect/spawner/lootdrop/maintenance/three,
/turf/open/floor/plating,
/area/ship/maintenance/central)
"Pb" = (
/obj/structure/girder,
/obj/structure/grille,
/obj/structure/cable{
	icon_state = "1-2"
	},
/obj/structure/cable,
/turf/open/floor/plating,
/area/ship/maintenance/central)
"Pc" = (
/obj/machinery/button/door{
	dir = 8;
	id = "portloadingbay";
	name = "Loading Bay Blast Doors Control";
	pixel_x = 25
	},
/turf/open/floor/plating,
/area/ship/cargo)
"Py" = (
/obj/machinery/power/apc/auto_name/north,
/obj/structure/cable{
	icon_state = "0-2"
	},
/turf/open/floor/plating,
/area/ship/maintenance/central)
"PG" = (
/obj/structure/cable{
	icon_state = "4-8"
	},
/obj/structure/cable{
	icon_state = "1-8"
	},
/turf/open/floor/plating,
/area/ship/maintenance/central)
"Qo" = (
/obj/structure/fans/tiny,
/obj/machinery/door/airlock/external,
/turf/open/floor/plating,
/area/ship/maintenance/central)
"Re" = (
/obj/structure/cable{
	icon_state = "1-4"
	},
/turf/open/floor/plating,
/area/ship/maintenance/central)
"RD" = (
/obj/machinery/power/smes/shuttle/precharged{
	dir = 1
	},
/obj/structure/cable{
	icon_state = "0-2"
	},
/turf/open/floor/plating,
/area/ship/engineering)
"RN" = (
/obj/structure/cable{
	icon_state = "1-8"
	},
/turf/open/floor/plating,
/area/ship/maintenance/central)
"RO" = (
/turf/closed/wall,
/area/ship/cargo)
"Sd" = (
/obj/structure/mopbucket,
/obj/item/mop,
/obj/item/reagent_containers/glass/bucket,
/turf/open/floor/plating,
/area/ship/crew/janitor)
"SF" = (
/obj/structure/cable{
	icon_state = "4-8"
	},
/obj/machinery/door/airlock/maintenance_hatch,
/turf/open/floor/plating,
/area/ship/cargo)
"SK" = (
/obj/structure/cable{
	icon_state = "4-8"
	},
/obj/effect/spawner/lootdrop/maintenance,
/turf/open/floor/plating,
/area/ship/maintenance/central)
"Tc" = (
/obj/machinery/microwave,
/obj/structure/table/reinforced,
/turf/open/floor/plating,
/area/ship/maintenance/central)
"Tv" = (
/obj/effect/decal/cleanable/xenoblood,
/turf/open/floor/plating,
/area/ship/engineering)
"TH" = (
/obj/structure/closet/crate/secure/loot,
/mob/living/simple_animal/bot/medbot,
/obj/item/circuitboard/machine/mining_equipment_vendor,
/obj/effect/spawner/lootdrop/maintenance/three,
/turf/open/floor/plating,
/area/ship/maintenance/central)
"TN" = (
/obj/structure/girder,
/obj/structure/grille,
/obj/structure/cable{
	icon_state = "0-4"
	},
/obj/structure/cable{
	icon_state = "2-4"
	},
/turf/open/floor/plating,
/area/ship/maintenance/central)
"TS" = (
/obj/structure/cable{
	icon_state = "4-8"
	},
/obj/effect/decal/cleanable/blood,
/turf/open/floor/plating,
/area/ship/maintenance/central)
"Ua" = (
/obj/structure/cable{
	icon_state = "4-8"
	},
/turf/open/floor/plating,
/area/ship/medical)
"Uk" = (
/obj/structure/cable{
	icon_state = "1-2"
	},
/obj/machinery/door/airlock/maintenance_hatch,
/turf/open/floor/plating,
/area/ship/crew/dorm)
"Uu" = (
/obj/machinery/power/apc/auto_name/south,
/obj/structure/cable,
/turf/open/floor/plating,
/area/ship/bridge)
"Uv" = (
/obj/machinery/power/apc/auto_name/east,
/obj/structure/cable{
	icon_state = "0-8"
	},
/turf/open/floor/plating,
/area/ship/science)
"UF" = (
/turf/open/floor/plating,
/area/ship/bridge)
"UN" = (
/turf/closed/wall,
/area/ship/science)
"Vj" = (
/obj/effect/spawner/lootdrop/maintenance/eight,
/obj/structure/closet/crate,
/turf/open/floor/plating,
/area/ship/cargo)
"Vl" = (
/obj/machinery/door/airlock/maintenance_hatch,
/obj/effect/decal/cleanable/oil/slippery,
/turf/open/floor/plating,
/area/ship/cargo)
"Vo" = (
/obj/structure/cable{
	icon_state = "2-4"
	},
/obj/structure/cable{
	icon_state = "1-2"
	},
/turf/open/floor/plating,
/area/ship/maintenance/central)
"Vy" = (
/obj/structure/cable{
	icon_state = "4-8"
	},
/turf/open/floor/plating,
/area/ship/crew/janitor)
"Vz" = (
/obj/structure/tank_dispenser,
/turf/open/floor/plating,
/area/ship/cargo)
"VG" = (
/obj/structure/cable{
	icon_state = "4-8"
	},
/obj/structure/cable{
	icon_state = "1-4"
	},
/turf/open/floor/plating,
/area/ship/science)
"VI" = (
/obj/structure/cable{
	icon_state = "1-8"
	},
/obj/machinery/atmospherics/pipe/simple/purple/visible{
	dir = 10
	},
/turf/open/floor/plating,
/area/ship/engineering)
"VJ" = (
/obj/structure/cable{
	icon_state = "1-2"
	},
/obj/structure/closet,
/turf/open/floor/plating,
/area/ship/maintenance/central)
"VO" = (
/obj/machinery/power/shuttle/engine/electric{
	dir = 1
	},
/obj/structure/cable,
/obj/structure/window/reinforced{
	dir = 1
	},
/turf/open/floor/plating,
/area/ship/external)
"Xz" = (
/obj/structure/cable{
	icon_state = "4-8"
	},
/obj/machinery/door/airlock/maintenance_hatch,
/turf/open/floor/plating,
/area/ship/engineering)
"YL" = (
/obj/structure/closet/crate,
/obj/item/research_notes/loot/big,
/obj/effect/spawner/lootdrop/two_percent_xeno_egg_spawner,
/obj/item/circuitboard/machine/ore_silo,
/turf/open/floor/plating,
/area/ship/maintenance/central)
"YR" = (
/obj/structure/cable{
	icon_state = "2-8"
	},
/obj/structure/cable{
	icon_state = "1-8"
	},
/obj/structure/cable{
	icon_state = "4-8"
	},
/turf/open/floor/plating,
/area/ship/maintenance/central)
"Zh" = (
/obj/structure/cable{
	icon_state = "4-8"
	},
/obj/machinery/door/airlock/maintenance_hatch,
/turf/open/floor/plating,
/area/ship/maintenance/central)
"Zm" = (
/turf/open/floor/plating,
/area/ship/cargo)
"Zs" = (
/obj/structure/cable{
	icon_state = "0-4"
	},
/obj/machinery/power/apc/auto_name/west,
/turf/open/floor/plating,
/area/ship/engineering)
"ZK" = (
/obj/machinery/power/apc/auto_name/south,
/obj/structure/cable,
/turf/open/floor/plating,
/area/ship/cargo)

(1,1,1) = {"
UN
UN
UN
UN
UN
UN
Qo
LC
LC
LC
LC
LC
LC
LC
LC
LC
LC
LC
zG
LC
LC
LC
LC
LC
LC
"}
(2,1,1) = {"
UN
aO
aO
AS
MI
As
Re
Mp
Mp
tY
LC
Mp
Mp
oF
ML
xt
sR
Re
Mp
Mp
CI
Mp
Mp
pq
LC
"}
(3,1,1) = {"
UN
aO
iD
eO
fL
UN
aA
pB
Mp
No
az
ML
HW
PG
LC
kB
LC
nE
hz
Mp
im
im
hS
im
im
"}
(4,1,1) = {"
UN
es
MI
VG
aO
UN
El
zv
zv
ms
zv
zv
Mp
CY
CI
la
LC
LC
aA
Mp
im
AR
gh
RD
VO
"}
(5,1,1) = {"
UN
eO
aO
Uv
Gl
UN
aA
zv
qj
Ua
AW
zv
Mp
TS
LC
Mp
Mp
Dr
dS
jW
im
uq
km
RD
VO
"}
(6,1,1) = {"
UN
jg
UN
UN
UN
UN
aA
zv
JV
aY
GB
zv
Mp
aA
LC
Tc
Fo
LC
aA
Mp
im
IW
dK
BQ
im
"}
(7,1,1) = {"
LC
HM
wB
LC
Mp
Mp
iR
zv
zv
zv
zv
zv
LC
Zh
LC
LC
LC
LC
Zh
LC
im
im
Xz
im
im
"}
(8,1,1) = {"
LC
Mp
rn
Pb
xt
ML
vI
ML
ML
ML
az
ML
ML
xd
sz
sR
iz
ML
RN
LC
jW
Mp
iR
Mp
LC
"}
(9,1,1) = {"
LC
LC
LC
LC
aA
hT
bV
hT
hT
tQ
LC
LC
LC
LC
LC
LC
aA
pB
Mp
LC
oF
ML
RN
Oo
LC
"}
(10,1,1) = {"
LC
Oo
oF
Cu
IT
hT
Vy
qP
hT
Mp
iJ
LC
oF
VJ
dO
ML
PG
Mp
Oo
LC
Zh
im
im
im
im
"}
(11,1,1) = {"
LC
Mp
aA
LC
aA
hT
zF
Sd
hT
Mp
jR
jR
sB
jR
jR
Mp
aA
LC
LC
LC
aA
im
AV
uN
lN
"}
(12,1,1) = {"
LC
Mp
aA
LC
dC
hT
hT
hT
hT
Ao
jR
Nd
nB
Uu
jR
Mp
rn
Em
ML
ML
yX
LX
yH
qd
im
"}
(13,1,1) = {"
EX
Py
hQ
LC
aA
Mp
pB
Mp
Mp
jW
jR
lf
Gf
UF
jR
LC
LC
aA
Mp
Mp
im
im
tV
rz
im
"}
(14,1,1) = {"
LC
Mp
SK
LC
aA
Mp
Mp
zr
Mp
Mp
jR
Ji
gq
ux
jR
TH
TN
RN
Mp
Mp
im
al
cH
NP
im
"}
(15,1,1) = {"
LC
Mp
iR
LC
aA
eM
eM
eM
eM
fQ
jR
jR
Kr
jR
jR
LC
aA
Mp
LC
Ao
im
ef
VI
uN
lN
"}
(16,1,1) = {"
LC
oF
xd
Pb
YR
Uk
nC
lo
eM
Mp
LC
Mp
aA
Mp
LC
Mp
aA
GV
LC
Mp
im
Xz
im
im
im
"}
(17,1,1) = {"
LC
Fw
LC
LC
aA
eM
dh
is
eM
Mp
LC
pB
aA
Mp
LC
Mp
TS
LC
LC
Mp
oF
RN
fP
Lc
LC
"}
(18,1,1) = {"
LC
Ak
Re
LC
aA
eM
pM
rW
eM
oF
sR
ML
xd
ML
sR
Vo
sx
ML
ML
sz
IT
im
im
im
im
"}
(19,1,1) = {"
LC
LC
kB
LC
iR
eM
eM
eM
eM
aA
RO
Vl
RO
RO
RO
SF
RO
Mp
Mp
Mp
TS
im
Zs
qF
im
"}
(20,1,1) = {"
LC
pB
Mp
LC
HM
wL
Re
Mp
oF
RN
RO
Zm
Vz
vE
mc
Hh
RO
Mp
Mp
pB
HM
LX
jH
Tv
im
"}
(21,1,1) = {"
LC
jW
LC
LC
LC
Mp
ku
ML
Cg
RO
RO
Zm
Zm
Zm
Ew
ZK
RO
Ao
LC
LC
fP
im
mb
RD
VO
"}
(22,1,1) = {"
LC
Mp
jW
nP
LC
Mp
iR
LC
LC
RO
Mw
Zm
Vj
NY
Zm
NY
RO
Mp
LC
kT
Mp
im
mb
RD
VO
"}
(23,1,1) = {"
LC
jW
Mp
Mp
LC
Mp
aA
LC
YL
RO
Mw
Zm
Zm
Zm
uM
hl
RO
Mp
Mp
pB
Mp
im
gj
Hi
im
"}
(24,1,1) = {"
LC
nP
jW
Mp
LC
Mp
HM
CI
oU
RO
Mw
as
Zm
Zm
Zm
Pc
RO
Mp
Mp
tQ
tY
im
iO
mh
im
"}
(25,1,1) = {"
LC
LC
LC
LC
LC
LC
zG
LC
LC
RO
qQ
qQ
qQ
qQ
qQ
RO
RO
LC
Qo
LC
LC
im
im
im
im
"}
