"a" = (/turf/template_noop,/area/template_noop)
"f" = (/obj/structure/window/shuttle,/obj/structure/grille,/turf/open/floor/plating,/area/ship/bridge)
"h" = (/obj/machinery/computer/helm,/turf/open/floor/carpet/executive,/area/ship/bridge)
"i" = (/obj/machinery/computer/monitor,/turf/open/floor/carpet/executive,/area/ship/bridge)
"j" = (/turf/open/floor/carpet/executive,/area/ship/bridge)
"k" = (/obj/machinery/computer/autopilot,/turf/open/floor/carpet/executive,/area/ship/bridge)
"l" = (/turf/closed/wall/mineral/titanium/nodiagonal,/area/ship/bridge)
"n" = (/obj/structure/closet/wall/red{dir = 8; pixel_x = -32},/obj/machinery/light{dir = 1},/obj/item/tank/internals/emergency_oxygen/double/empty,/obj/item/tank/internals/emergency_oxygen/double/empty,/obj/item/tank/internals/emergency_oxygen/double/empty,/obj/item/mining_scanner,/obj/item/mining_scanner,/obj/item/mining_scanner,/obj/item/resonator,/obj/item/resonator,/obj/item/resonator,/obj/item/storage/bag/ore,/obj/item/storage/bag/ore,/obj/item/storage/bag/ore,/turf/open/floor/carpet/executive,/area/ship/bridge)
"r" = (/obj/item/areaeditor/shuttle,/turf/open/floor/carpet/executive,/area/ship/bridge)
"s" = (/obj/machinery/holopad/emergency/command,/turf/open/floor/carpet/executive,/area/ship/bridge)
"u" = (/obj/machinery/vending/security/marine/solgov,/obj/machinery/light{dir = 1},/obj/structure/sign/poster/official/random{pixel_x = 32},/turf/open/floor/carpet/executive,/area/ship/bridge)
"v" = (/obj/machinery/door/airlock/shuttle/glass,/obj/structure/fans/tiny,/turf/open/floor/carpet/executive,/area/ship/bridge)
"w" = (/obj/machinery/door/airlock/shuttle/glass,/obj/structure/fans/tiny,/obj/docking_port/mobile{can_move_docking_ports = 1; dir = 4; name = "Nanopill"; port_direction = 8},/turf/open/floor/carpet/executive,/area/ship/bridge)
"x" = (/obj/machinery/computer/cryopod{pixel_x = -32},/obj/machinery/cryopod{dir = 4},/turf/open/floor/iron,/area/ship/bridge)
"z" = (/obj/machinery/mineral/ore_redemption{dir = 8},/obj/structure/fans/tiny,/obj/machinery/door/window{dir = 4},/obj/machinery/door/window{dir = 8},/turf/open/floor/iron,/area/ship/bridge)
"B" = (/obj/machinery/suit_storage_unit/ert/security{storage_type = /obj/item/tank/jetpack/oxygen},/obj/effect/turf_decal/box/white,/obj/machinery/light{dir = 8},/obj/structure/sign/poster/official/random{pixel_x = -32},/turf/open/floor/iron,/area/ship/bridge)
"C" = (/obj/machinery/power/apc/auto_name/east,/obj/structure/cable{icon_state = "0-2"},/obj/machinery/power/terminal{dir = 4},/obj/machinery/light{dir = 4},/obj/item/reagent_containers/glass/bucket,/obj/item/mop,/obj/structure/reagent_dispensers/watertank,/turf/open/floor/carpet/executive,/area/ship/bridge)
"D" = (/obj/machinery/suit_storage_unit/ert/security{storage_type = /obj/item/tank/jetpack/oxygen},/obj/effect/turf_decal/box/white,/turf/open/floor/iron,/area/ship/bridge)
"F" = (/obj/structure/cable{icon_state = "2-4"},/turf/open/floor/carpet/executive,/area/ship/bridge)
"G" = (/obj/structure/cable{icon_state = "4-8"},/turf/open/floor/carpet/executive,/area/ship/bridge)
"J" = (/obj/structure/cable{icon_state = "2-8"},/obj/machinery/autolathe,/obj/structure/cable{icon_state = "1-2"},/turf/open/floor/iron,/area/ship/bridge)
"K" = (/obj/structure/sign/nanotrasen,/turf/closed/wall/mineral/titanium/nodiagonal,/area/ship/bridge)
"M" = (/obj/structure/cable{icon_state = "1-2"},/turf/open/floor/carpet/executive,/area/ship/bridge)
"N" = (/obj/machinery/power/terminal{dir = 4},/obj/structure/cable/yellow{icon_state = "0-2"},/turf/open/floor/carpet/executive,/area/ship/bridge)
"O" = (/obj/machinery/power/smes/engineering,/obj/structure/cable,/turf/open/floor/iron,/area/ship/bridge)
"P" = (/obj/structure/closet/crate/engineering,/obj/item/stack/sheet/mineral/plasma/fifty,/obj/item/stack/sheet/mineral/plasma/fifty,/obj/item/storage/toolbox/mechanical,/obj/machinery/light,/obj/structure/sign/poster/official/random{pixel_x = -32},/obj/item/pipe_dispenser,/turf/open/floor/carpet/executive,/area/ship/bridge)
"S" = (/obj/machinery/power/terminal,/obj/structure/cable,/turf/open/floor/carpet/executive,/area/ship/bridge)
"W" = (/obj/machinery/power/port_gen/pacman,/obj/structure/cable/yellow,/obj/machinery/light,/turf/open/floor/carpet/executive,/area/ship/bridge)
"X" = (/obj/machinery/power/smes/shuttle/precharged{dir = 1},/obj/structure/window/reinforced,/obj/structure/cable/yellow{icon_state = "0-2"},/turf/open/floor/carpet/executive,/area/ship/bridge)
"Y" = (/obj/machinery/power/shuttle/engine/electric{dir = 1},/obj/structure/cable/yellow,/turf/open/floor/plating,/area/ship/bridge)

(1,1,1) = {"
aafffaa
affhffa
ffirkff
lnjsjul
vjjjjjw
lxjjjjz
lBjjjCl
fDjFGJf
KDjMNOK
llPSWll
allXlla
aalYlaa
"}
