//MAP CONVERTED BY dmm2tgm.py THIS HEADER COMMENT PREVENTS RECONVERSION, DO NOT REMOVE
"a" = (
/obj/structure/window/reinforced/spawner/west,
/obj/machinery/power/smes/shuttle/precharged{
	dir = 4
	},
/obj/structure/cable{
	icon_state = "0-8"
	},
/obj/machinery/door/window/eastleft{
	name = "Engine Access"
	},
/turf/open/floor/plating,
/area/ship/construction)
"b" = (
/obj/structure/catwalk/over,
/obj/structure/cable{
	icon_state = "4-8"
	},
/turf/open/floor/plating/airless,
/area/ship/external)
"c" = (
/obj/structure/catwalk/over,
/obj/structure/railing{
	dir = 9
	},
/turf/open/floor/plating/airless,
/area/ship/external)
"d" = (
/obj/structure/catwalk/over,
/obj/structure/railing{
	dir = 8
	},
/turf/open/floor/plating/airless,
/area/ship/external)
"f" = (
/obj/structure/catwalk/over,
/obj/structure/railing/corner{
	dir = 1
	},
/turf/open/floor/plating/airless,
/area/ship/external)
"g" = (
/obj/machinery/power/shuttle/engine/electric{
	dir = 4
	},
/obj/structure/cable{
	icon_state = "0-4"
	},
/obj/structure/railing/corner{
	dir = 8
	},
/obj/structure/railing/corner{
	dir = 1
	},
/turf/open/floor/plating,
/area/ship/construction)
"h" = (
/obj/machinery/door/airlock/external/glass,
/obj/structure/fans/tiny,
/obj/structure/cable{
	icon_state = "1-2"
	},
/turf/open/floor/plating,
/area/ship/construction)
"i" = (
/turf/closed/wall,
/area/ship/construction)
"j" = (
/obj/structure/catwalk/over,
/obj/structure/cable{
	icon_state = "1-4"
	},
/turf/open/floor/plating/airless,
/area/ship/external)
"k" = (
/obj/item/construction/rcd/combat,
/obj/item/construction/rcd/combat,
/obj/item/construction/rcd/combat,
/obj/item/construction/rcd/combat,
/obj/item/construction/rcd/combat,
/obj/structure/closet/crate/large{
	name = "equipment crate"
	},
/obj/item/storage/toolbox/mechanical,
/obj/item/storage/toolbox/mechanical,
/obj/item/storage/toolbox/mechanical,
/obj/item/storage/toolbox/mechanical,
/obj/item/storage/toolbox/mechanical,
/obj/item/clothing/shoes/magboots,
/obj/item/clothing/shoes/magboots,
/obj/item/clothing/shoes/magboots,
/obj/item/clothing/shoes/magboots,
/obj/item/clothing/shoes/magboots,
/obj/item/clothing/suit/space/hardsuit/mining/independent,
/obj/item/clothing/suit/space/hardsuit/mining/independent,
/obj/item/clothing/suit/space/hardsuit/mining/independent,
/obj/item/clothing/suit/space/hardsuit/mining/independent,
/obj/item/clothing/suit/space/hardsuit/mining/independent,
/obj/item/clothing/mask/gas,
/obj/item/clothing/mask/gas,
/obj/item/clothing/mask/gas,
/obj/item/clothing/mask/gas,
/obj/item/clothing/mask/gas,
/obj/item/tank/internals/oxygen,
/obj/item/tank/internals/oxygen,
/obj/item/tank/internals/oxygen,
/obj/item/tank/internals/oxygen,
/obj/item/tank/internals/oxygen,
/obj/item/tank/jetpack/oxygen,
/obj/item/tank/jetpack/oxygen,
/obj/item/tank/jetpack/oxygen,
/obj/item/tank/jetpack/oxygen,
/obj/item/tank/jetpack/oxygen,
/obj/item/clothing/gloves/color/yellow,
/obj/item/clothing/gloves/color/yellow,
/obj/item/clothing/gloves/color/yellow,
/obj/item/clothing/gloves/color/yellow,
/obj/machinery/light/small,
/obj/item/clothing/gloves/color/yellow,
/obj/structure/cable{
	icon_state = "1-8"
	},
/turf/open/floor/plasteel,
/area/ship/construction)
"l" = (
/obj/structure/catwalk/over,
/obj/structure/cable{
	icon_state = "1-8"
	},
/turf/open/floor/plating/airless,
/area/ship/external)
"m" = (
/obj/structure/closet/crate/large{
	name = "parts crate"
	},
/obj/item/storage/part_replacer/cargo,
/obj/item/storage/part_replacer/cargo,
/obj/item/storage/part_replacer/cargo,
/obj/item/storage/box/stockparts/basic,
/obj/item/storage/box/stockparts/basic,
/obj/item/storage/box/stockparts/basic,
/obj/item/storage/box/stockparts/basic,
/obj/item/storage/box/stockparts/basic,
/obj/item/storage/box/stockparts/basic,
/obj/item/storage/box/stockparts/basic,
/obj/item/storage/box/stockparts/basic,
/obj/item/storage/box/stockparts/basic,
/obj/item/storage/box/stockparts/basic,
/obj/item/storage/box/stockparts/t2,
/obj/item/storage/box/stockparts/t2,
/obj/item/assembly/igniter,
/obj/item/stock_parts/cell/high/plus{
	charge = 15000
	},
/obj/item/stock_parts/cell/high/plus{
	charge = 15000
	},
/obj/item/stock_parts/cell/high/plus{
	charge = 15000
	},
/obj/item/stock_parts/cell/high/plus{
	charge = 15000
	},
/obj/item/stock_parts/cell/high/plus{
	charge = 15000
	},
/obj/item/stock_parts/cell/high/plus{
	charge = 15000
	},
/obj/item/stock_parts/cell/high/plus{
	charge = 15000
	},
/obj/item/stock_parts/cell/high/plus{
	charge = 15000
	},
/obj/item/stock_parts/cell/high/plus{
	charge = 15000
	},
/obj/item/stock_parts/cell/high/plus{
	charge = 15000
	},
/obj/item/stock_parts/cell/high/plus{
	charge = 15000
	},
/obj/item/stock_parts/cell/high/plus{
	charge = 15000
	},
/obj/item/stock_parts/cell/high/plus{
	charge = 15000
	},
/obj/item/stock_parts/cell/high/plus{
	charge = 15000
	},
/obj/item/stock_parts/cell/high/plus{
	charge = 15000
	},
/obj/item/stock_parts/cell/high/plus{
	charge = 15000
	},
/obj/item/stock_parts/cell/high/plus{
	charge = 15000
	},
/obj/item/stock_parts/cell/high/plus{
	charge = 15000
	},
/obj/item/stock_parts/cell/high/plus{
	charge = 15000
	},
/obj/item/stock_parts/cell/high/plus{
	charge = 15000
	},
/obj/structure/catwalk/over,
/obj/structure/railing{
	dir = 8
	},
/turf/open/floor/plating/airless,
/area/ship/external)
"n" = (
/obj/structure/cable{
	icon_state = "0-2"
	},
/obj/machinery/power/port_gen/pacman,
/obj/item/stack/sheet/mineral/plasma/fifty,
/turf/open/floor/plasteel,
/area/ship/construction)
"o" = (
/obj/structure/catwalk/over,
/obj/machinery/power/terminal{
	dir = 8
	},
/obj/structure/cable{
	icon_state = "0-2"
	},
/obj/structure/railing/corner{
	dir = 1
	},
/turf/open/floor/plating/airless,
/area/ship/external)
"p" = (
/obj/structure/catwalk/over,
/obj/structure/cable{
	icon_state = "2-4"
	},
/obj/structure/cable{
	icon_state = "4-8"
	},
/turf/open/floor/plating/airless,
/area/ship/external)
"q" = (
/obj/structure/closet/crate/large{
	name = "circuitry crate"
	},
/obj/item/circuitboard/computer/communications,
/obj/item/circuitboard/computer/cargo/express,
/obj/item/circuitboard/machine/autolathe,
/obj/item/circuitboard/machine/microwave,
/obj/item/circuitboard/machine/ore_silo,
/obj/item/circuitboard/machine/pacman,
/obj/item/circuitboard/machine/pacman,
/obj/item/circuitboard/machine/pacman/uranium,
/obj/item/circuitboard/machine/pacman/uranium,
/obj/item/circuitboard/machine/pacman/diamond,
/obj/item/circuitboard/machine/shuttle/heater,
/obj/item/circuitboard/machine/shuttle/heater,
/obj/item/circuitboard/machine/shuttle/heater,
/obj/item/circuitboard/machine/shuttle/heater,
/obj/item/circuitboard/machine/shuttle/heater,
/obj/item/circuitboard/machine/shuttle/heater,
/obj/item/circuitboard/machine/shuttle/smes,
/obj/item/circuitboard/machine/shuttle/smes,
/obj/item/circuitboard/machine/shuttle/smes,
/obj/item/circuitboard/machine/shuttle/smes,
/obj/item/circuitboard/machine/shuttle/smes,
/obj/item/circuitboard/machine/shuttle/smes,
/obj/item/circuitboard/machine/shuttle/smes,
/obj/item/circuitboard/machine/shuttle/engine/electric,
/obj/item/circuitboard/machine/shuttle/engine/electric,
/obj/item/circuitboard/machine/shuttle/engine/electric,
/obj/item/circuitboard/machine/shuttle/engine/electric,
/obj/item/circuitboard/machine/shuttle/engine/electric,
/obj/item/circuitboard/machine/shuttle/engine/electric,
/obj/item/circuitboard/machine/shuttle/engine/plasma,
/obj/item/circuitboard/machine/shuttle/engine/plasma,
/obj/item/circuitboard/machine/shuttle/engine/plasma,
/obj/item/circuitboard/machine/shuttle/engine/plasma,
/obj/item/circuitboard/machine/shuttle/engine/plasma,
/obj/item/circuitboard/machine/shuttle/engine/plasma,
/obj/item/circuitboard/machine/thermomachine/freezer,
/obj/item/circuitboard/machine/thermomachine/heater,
/obj/item/circuitboard/machine/circulator,
/obj/item/circuitboard/machine/circulator,
/obj/item/circuitboard/computer/selling_pad_control,
/obj/item/circuitboard/machine/selling_pad,
/obj/item/storage/box/rndboards{
	name = "research boards";
	desc = "A box containing circuit boards for establishing research and development equipment."
	},
/obj/item/circuitboard/machine/smes,
/obj/item/circuitboard/machine/smes,
/obj/item/circuitboard/machine/smes,
/obj/item/circuitboard/machine/sleeper,
/obj/item/circuitboard/machine/sleeper,
/obj/item/circuitboard/machine/sleeper,
/obj/structure/catwalk/over,
/obj/item/circuitboard/machine/generator,
/obj/item/circuitboard/machine/power_compressor,
/obj/item/circuitboard/machine/power_turbine,
/obj/item/circuitboard/computer/turbine_computer,
/turf/open/floor/plating/airless,
/area/ship/external)
"r" = (
/obj/machinery/light/small{
	dir = 1
	},
/obj/machinery/computer/helm,
/turf/open/floor/plasteel,
/area/ship/construction)
"t" = (
/obj/structure/catwalk/over,
/obj/structure/railing,
/turf/open/floor/plating/airless,
/area/ship/external)
"u" = (
/obj/structure/cable,
/obj/machinery/power/terminal,
/turf/open/floor/plasteel,
/area/ship/construction)
"v" = (
/obj/structure/catwalk/over,
/obj/machinery/power/terminal{
	dir = 8
	},
/obj/structure/cable,
/obj/structure/railing/corner{
	dir = 8
	},
/turf/open/floor/plating/airless,
/area/ship/external)
"w" = (
/obj/structure/catwalk/over,
/obj/structure/railing/corner{
	dir = 8
	},
/turf/open/floor/plating/airless,
/area/ship/external)
"x" = (
/obj/structure/catwalk/over,
/obj/structure/cable{
	icon_state = "4-8"
	},
/obj/docking_port/mobile{
	can_move_docking_ports = 1;
	dir = 2;
	dwidth = 13;
	height = 9;
	launch_status = 0;
	port_direction = 8;
	preferred_direction = 4;
	width = 13
	},
/turf/open/floor/plating/airless,
/area/ship/external)
"y" = (
/obj/structure/catwalk/over,
/obj/structure/cable{
	icon_state = "2-8"
	},
/turf/open/floor/plating/airless,
/area/ship/external)
"z" = (
/obj/machinery/power/smes/shuttle/precharged{
	dir = 4
	},
/obj/structure/cable{
	icon_state = "0-8"
	},
/obj/structure/railing,
/obj/structure/railing{
	dir = 1
	},
/turf/open/floor/plating/airless,
/area/ship/external)
"A" = (
/obj/structure/catwalk/over,
/obj/structure/cable,
/obj/machinery/power/apc/auto_name/south,
/turf/open/floor/plating/airless,
/area/ship/external)
"B" = (
/obj/structure/catwalk/over,
/obj/structure/railing{
	dir = 10
	},
/turf/open/floor/plating/airless,
/area/ship/external)
"C" = (
/turf/template_noop,
/area/template_noop)
"D" = (
/obj/structure/cable{
	icon_state = "1-2"
	},
/turf/open/floor/plasteel,
/area/ship/construction)
"E" = (
/obj/structure/closet/crate/large{
	name = "material crate"
	},
/obj/item/stack/sheet/mineral/titanium/fifty,
/obj/item/stack/sheet/mineral/titanium/fifty,
/obj/item/stack/sheet/mineral/titanium/fifty,
/obj/item/stack/sheet/mineral/titanium/fifty,
/obj/item/stack/sheet/metal/fifty,
/obj/item/stack/sheet/metal/fifty,
/obj/item/stack/sheet/metal/fifty,
/obj/item/stack/sheet/metal/fifty,
/obj/item/stack/sheet/metal/fifty,
/obj/item/stack/sheet/metal/fifty,
/obj/item/stack/sheet/metal/fifty,
/obj/item/stack/sheet/metal/fifty,
/obj/item/stack/sheet/mineral/plasma/fifty,
/obj/item/stack/sheet/mineral/plasma/fifty,
/obj/item/stack/sheet/mineral/silver/twenty,
/obj/item/stack/sheet/mineral/uranium/twenty,
/obj/item/stack/sheet/plasmarglass{
	amount = 25
	},
/obj/item/stack/sheet/titaniumglass{
	amount = 50
	},
/obj/item/stack/sheet/titaniumglass{
	amount = 50
	},
/obj/item/stack/sheet/titaniumglass{
	amount = 50
	},
/obj/item/stack/sheet/glass/fifty,
/obj/item/stack/sheet/glass/fifty,
/obj/item/stack/sheet/glass/fifty,
/obj/item/stack/sheet/glass/fifty,
/obj/item/stack/sheet/glass/fifty,
/obj/item/stack/sheet/glass/fifty,
/obj/item/stack/sheet/mineral/gold/twenty,
/obj/item/stack/sheet/mineral/diamond/five,
/obj/item/stack/cable_coil/red,
/obj/item/stack/cable_coil/red,
/obj/item/stack/cable_coil/red,
/obj/item/stack/cable_coil/red,
/obj/item/stack/cable_coil/red,
/obj/item/stack/cable_coil/red,
/obj/structure/catwalk/over,
/obj/structure/railing{
	dir = 8
	},
/turf/open/floor/plating/airless,
/area/ship/external)
"F" = (
/obj/structure/closet/crate/large{
	name = "atmospherics crate"
	},
/obj/item/sbeacondrop/atmospherics/nitrogen_miner,
/obj/item/sbeacondrop/atmospherics/oxygen_miner,
/obj/item/sbeacondrop/atmospherics/plasma_miner,
/obj/item/pipe_dispenser,
/obj/item/pipe_dispenser,
/obj/item/pipe_dispenser,
/obj/structure/catwalk/over,
/obj/item/paper{
	info = "DO NOT ACTIVATE THE GAS MINER TELEPORTERS OUTSIDE OF THE APPROPRIATE TANKS YOU FUCKING DIMWITS!!";
	color = "#ff0000";
	desc = "Seems important. That's why it's red."
	},
/obj/item/holosign_creator/atmos,
/turf/open/floor/plating/airless,
/area/ship/external)
"G" = (
/obj/structure/cable{
	icon_state = "0-8"
	},
/obj/structure/cable{
	icon_state = "4-8"
	},
/obj/machinery/power/smes/engineering,
/turf/open/floor/plasteel,
/area/ship/construction)
"H" = (
/turf/open/floor/plasteel,
/area/ship/construction)
"I" = (
/obj/machinery/power/shuttle/engine/electric{
	dir = 4
	},
/obj/structure/cable{
	icon_state = "0-4"
	},
/obj/structure/railing{
	dir = 1
	},
/obj/structure/railing,
/turf/open/floor/plating/airless,
/area/ship/external)
"K" = (
/obj/structure/cable{
	icon_state = "1-4"
	},
/obj/machinery/light/small{
	dir = 8
	},
/turf/open/floor/plating,
/area/ship/construction)
"L" = (
/obj/structure/cable{
	icon_state = "1-2"
	},
/obj/structure/cable{
	icon_state = "2-4"
	},
/turf/open/floor/plasteel,
/area/ship/construction)
"M" = (
/obj/effect/spawner/structure/window/reinforced/shutters,
/turf/open/floor/plating,
/area/ship/construction)
"N" = (
/obj/structure/catwalk/over,
/obj/structure/railing{
	dir = 1
	},
/turf/open/floor/plating/airless,
/area/ship/external)
"O" = (
/obj/structure/catwalk/over,
/obj/structure/cable{
	icon_state = "2-4"
	},
/turf/open/floor/plating/airless,
/area/ship/external)
"P" = (
/obj/machinery/power/smes/shuttle/precharged{
	dir = 4
	},
/obj/structure/cable{
	icon_state = "0-8"
	},
/obj/structure/railing{
	dir = 1
	},
/obj/structure/railing,
/turf/open/floor/plating/airless,
/area/ship/external)
"Q" = (
/obj/structure/cable{
	icon_state = "2-8"
	},
/obj/structure/cable{
	icon_state = "1-8"
	},
/turf/open/floor/plasteel,
/area/ship/construction)
"R" = (
/obj/machinery/power/shuttle/engine/electric{
	dir = 4
	},
/obj/structure/cable{
	icon_state = "0-4"
	},
/obj/structure/railing,
/obj/structure/railing{
	dir = 1
	},
/turf/open/floor/plating/airless,
/area/ship/external)
"S" = (
/obj/structure/closet/crate/large{
	name = "miscellaneous crate"
	},
/obj/item/reagent_containers/food/snacks/rationpack,
/obj/item/reagent_containers/food/snacks/rationpack,
/obj/item/reagent_containers/food/snacks/rationpack,
/obj/item/reagent_containers/food/snacks/rationpack,
/obj/item/reagent_containers/food/snacks/rationpack,
/obj/item/reagent_containers/food/snacks/rationpack,
/obj/item/reagent_containers/food/snacks/rationpack,
/obj/item/reagent_containers/food/snacks/rationpack,
/obj/item/reagent_containers/food/snacks/rationpack,
/obj/item/reagent_containers/food/snacks/rationpack,
/obj/item/vending_refill/security,
/obj/item/vending_refill/security,
/obj/item/vending_refill/security,
/obj/item/storage/backpack/duffelbag/syndie/surgery,
/obj/item/reagent_containers/glass/bottle/antitoxin/sleeper,
/obj/item/reagent_containers/glass/bottle/bicaridine/sleeper,
/obj/item/reagent_containers/glass/bottle/dexalin/sleeper,
/obj/item/reagent_containers/glass/bottle/epinephrine/sleeper,
/obj/item/reagent_containers/glass/bottle/kelotane/sleeper,
/obj/item/reagent_containers/glass/bottle/morphine/sleeper,
/obj/item/storage/bag/chemistry,
/obj/structure/catwalk/over,
/obj/structure/railing{
	dir = 8
	},
/turf/open/floor/plating/airless,
/area/ship/external)
"T" = (
/obj/machinery/cryopod,
/obj/machinery/computer/cryopod{
	pixel_y = -32
	},
/obj/structure/cable{
	icon_state = "4-8"
	},
/turf/open/floor/plasteel,
/area/ship/construction)
"U" = (
/obj/machinery/airalarm/all_access{
	dir = 4;
	pixel_x = -24
	},
/obj/structure/closet/crate/medical,
/obj/item/storage/firstaid/brute,
/obj/item/storage/firstaid/fire,
/obj/item/storage/firstaid/medical,
/obj/item/defibrillator/loaded,
/turf/open/floor/plating,
/area/ship/construction)
"V" = (
/obj/structure/cable{
	icon_state = "0-2"
	},
/obj/machinery/power/apc/auto_name/north,
/obj/structure/closet/secure_closet/engineering_chief,
/obj/item/clothing/mask/gas,
/obj/item/tank/internals/oxygen,
/obj/item/clothing/suit/space/hardsuit/engine/elite,
/obj/item/areaeditor/shuttle,
/turf/open/floor/plasteel,
/area/ship/construction)
"W" = (
/obj/structure/catwalk/over,
/turf/open/floor/plating/airless,
/area/ship/external)
"Y" = (
/obj/structure/catwalk/over,
/obj/structure/cable{
	icon_state = "1-2"
	},
/turf/open/floor/plating/airless,
/area/ship/external)
"Z" = (
/obj/structure/cable{
	icon_state = "0-2"
	},
/obj/machinery/power/terminal{
	dir = 8
	},
/turf/open/floor/plating,
/area/ship/construction)

(1,1,1) = {"
C
I
c
S
m
E
B
R
C
"}
(2,1,1) = {"
C
P
N
W
q
F
t
z
C
"}
(3,1,1) = {"
O
v
f
W
W
W
w
o
j
"}
(4,1,1) = {"
b
C
C
d
g
d
C
C
b
"}
(5,1,1) = {"
b
C
i
i
a
i
i
C
b
"}
(6,1,1) = {"
p
A
i
U
Z
K
i
W
b
"}
(7,1,1) = {"
b
C
M
n
u
G
M
C
b
"}
(8,1,1) = {"
x
C
i
r
H
T
i
C
b
"}
(9,1,1) = {"
b
C
i
V
L
k
i
C
b
"}
(10,1,1) = {"
y
Y
h
D
Q
D
h
Y
l
"}
(11,1,1) = {"
W
C
i
M
M
M
i
C
W
"}
(12,1,1) = {"
W
C
C
W
C
W
C
C
W
"}
(13,1,1) = {"
W
W
W
W
W
W
W
W
W
"}
