//MAP CONVERTED BY dmm2tgm.py THIS HEADER COMMENT PREVENTS RECONVERSION, DO NOT REMOVE
"a" = (
/obj/machinery/power/shuttle/engine/electric{
	dir = 4
	},
/obj/structure/cable{
	icon_state = "0-4"
	},
/obj/structure/railing{
	dir = 1
	},
/obj/structure/railing,
/turf/open/floor/plating/airless,
/area/ship/external)
"b" = (
/obj/structure/cable,
/obj/machinery/power/terminal,
/turf/open/floor/plasteel,
/area/ship/construction)
"c" = (
/obj/structure/cable{
	icon_state = "1-4"
	},
/turf/open/floor/plating,
/area/ship/construction)
"d" = (
/obj/machinery/door/airlock/external/glass,
/obj/structure/fans/tiny,
/obj/structure/cable{
	icon_state = "1-2"
	},
/turf/open/floor/plating,
/area/ship/construction)
"e" = (
/obj/structure/cable{
	icon_state = "0-2"
	},
/obj/machinery/power/terminal{
	dir = 8
	},
/turf/open/floor/plating,
/area/ship/construction)
"f" = (
/obj/structure/closet/crate/large{
	name = "circuitry crate"
	},
/obj/item/circuitboard/computer/communications,
/obj/item/circuitboard/computer/cargo/express,
/obj/item/circuitboard/machine/autolathe,
/obj/item/circuitboard/machine/microwave,
/obj/item/circuitboard/machine/ore_silo,
/obj/item/circuitboard/machine/pacman,
/obj/item/circuitboard/machine/pacman,
/obj/item/circuitboard/machine/pacman/uranium,
/obj/item/circuitboard/machine/pacman/uranium,
/obj/item/circuitboard/machine/pacman/diamond,
/obj/item/circuitboard/machine/shuttle/heater,
/obj/item/circuitboard/machine/shuttle/heater,
/obj/item/circuitboard/machine/shuttle/heater,
/obj/item/circuitboard/machine/shuttle/heater,
/obj/item/circuitboard/machine/shuttle/heater,
/obj/item/circuitboard/machine/shuttle/heater,
/obj/item/circuitboard/machine/shuttle/smes,
/obj/item/circuitboard/machine/shuttle/smes,
/obj/item/circuitboard/machine/shuttle/smes,
/obj/item/circuitboard/machine/shuttle/smes,
/obj/item/circuitboard/machine/shuttle/smes,
/obj/item/circuitboard/machine/shuttle/smes,
/obj/item/circuitboard/machine/shuttle/smes,
/obj/item/circuitboard/machine/shuttle/engine/electric,
/obj/item/circuitboard/machine/shuttle/engine/electric,
/obj/item/circuitboard/machine/shuttle/engine/electric,
/obj/item/circuitboard/machine/shuttle/engine/electric,
/obj/item/circuitboard/machine/shuttle/engine/electric,
/obj/item/circuitboard/machine/shuttle/engine/electric,
/obj/item/circuitboard/machine/shuttle/engine/plasma,
/obj/item/circuitboard/machine/shuttle/engine/plasma,
/obj/item/circuitboard/machine/shuttle/engine/plasma,
/obj/item/circuitboard/machine/shuttle/engine/plasma,
/obj/item/circuitboard/machine/shuttle/engine/plasma,
/obj/item/circuitboard/machine/shuttle/engine/plasma,
/obj/item/circuitboard/machine/thermomachine/freezer,
/obj/item/circuitboard/machine/thermomachine/heater,
/obj/item/circuitboard/machine/circulator,
/obj/item/circuitboard/machine/circulator,
/obj/item/circuitboard/computer/selling_pad_control,
/obj/item/circuitboard/machine/selling_pad,
/obj/item/storage/box/rndboards{
	name = "research boards";
	desc = "A box containing circuit boards for establishing research and development equipment."
	},
/obj/item/circuitboard/machine/smes,
/obj/item/circuitboard/machine/smes,
/obj/item/circuitboard/machine/smes,
/obj/item/circuitboard/machine/sleeper,
/obj/item/circuitboard/machine/sleeper,
/obj/item/circuitboard/machine/sleeper,
/obj/structure/catwalk/over,
/turf/open/floor/plating/airless,
/area/ship/external)
"g" = (
/obj/machinery/light/small{
	dir = 1
	},
/obj/machinery/computer/helm,
/turf/open/floor/plasteel,
/area/ship/construction)
"h" = (
/obj/structure/catwalk/over,
/turf/open/floor/plating/airless,
/area/ship/external)
"i" = (
/obj/structure/catwalk/over,
/obj/structure/railing/corner{
	dir = 8
	},
/turf/open/floor/plating/airless,
/area/ship/external)
"j" = (
/obj/structure/catwalk/over,
/obj/structure/cable{
	icon_state = "1-4"
	},
/turf/open/floor/plating/airless,
/area/ship/external)
"k" = (
/obj/structure/cable{
	icon_state = "1-2"
	},
/turf/open/floor/plasteel,
/area/ship/construction)
"l" = (
/turf/open/floor/plasteel,
/area/ship/construction)
"m" = (
/obj/item/construction/rcd/combat,
/obj/item/construction/rcd/combat,
/obj/item/construction/rcd/combat,
/obj/item/construction/rcd/combat,
/obj/item/construction/rcd/combat,
/obj/structure/closet/crate/large{
	name = "equipment crate"
	},
/obj/item/storage/toolbox/mechanical,
/obj/item/storage/toolbox/mechanical,
/obj/item/storage/toolbox/mechanical,
/obj/item/storage/toolbox/mechanical,
/obj/item/storage/toolbox/mechanical,
/obj/item/clothing/shoes/magboots,
/obj/item/clothing/shoes/magboots,
/obj/item/clothing/shoes/magboots,
/obj/item/clothing/shoes/magboots,
/obj/item/clothing/shoes/magboots,
/obj/item/clothing/suit/space/hardsuit/mining/independent,
/obj/item/clothing/suit/space/hardsuit/mining/independent,
/obj/item/clothing/suit/space/hardsuit/mining/independent,
/obj/item/clothing/suit/space/hardsuit/mining/independent,
/obj/item/clothing/suit/space/hardsuit/mining/independent,
/obj/item/clothing/mask/gas,
/obj/item/clothing/mask/gas,
/obj/item/clothing/mask/gas,
/obj/item/clothing/mask/gas,
/obj/item/clothing/mask/gas,
/obj/item/tank/internals/oxygen,
/obj/item/tank/internals/oxygen,
/obj/item/tank/internals/oxygen,
/obj/item/tank/internals/oxygen,
/obj/item/tank/internals/oxygen,
/obj/item/tank/jetpack/oxygen,
/obj/item/tank/jetpack/oxygen,
/obj/item/tank/jetpack/oxygen,
/obj/item/tank/jetpack/oxygen,
/obj/item/tank/jetpack/oxygen,
/obj/item/clothing/gloves/color/yellow,
/obj/item/clothing/gloves/color/yellow,
/obj/item/clothing/gloves/color/yellow,
/obj/item/clothing/gloves/color/yellow,
/obj/machinery/light/small,
/obj/item/clothing/gloves/color/yellow,
/turf/open/floor/plasteel,
/area/ship/construction)
"n" = (
/obj/structure/catwalk/over,
/obj/structure/cable{
	icon_state = "1-2"
	},
/turf/open/floor/plating/airless,
/area/ship/external)
"o" = (
/obj/structure/catwalk/over,
/obj/structure/railing{
	dir = 9
	},
/turf/open/floor/plating/airless,
/area/ship/external)
"p" = (
/turf/open/floor/plating,
/area/ship/construction)
"r" = (
/obj/structure/catwalk/over,
/obj/structure/railing{
	dir = 1
	},
/turf/open/floor/plating/airless,
/area/ship/external)
"s" = (
/obj/structure/cable{
	icon_state = "0-2"
	},
/obj/machinery/power/apc/auto_name/north,
/obj/structure/closet/secure_closet/captains,
/turf/open/floor/plasteel,
/area/ship/construction)
"t" = (
/obj/structure/catwalk/over,
/obj/structure/cable{
	icon_state = "2-4"
	},
/turf/open/floor/plating/airless,
/area/ship/external)
"u" = (
/obj/machinery/cryopod,
/obj/machinery/computer/cryopod{
	pixel_y = -32
	},
/obj/structure/cable{
	icon_state = "4-8"
	},
/turf/open/floor/plasteel,
/area/ship/construction)
"v" = (
/obj/structure/cable{
	icon_state = "0-8"
	},
/obj/structure/cable{
	icon_state = "4-8"
	},
/obj/machinery/power/smes/engineering,
/turf/open/floor/plasteel,
/area/ship/construction)
"w" = (
/obj/structure/closet/crate/large{
	name = "parts crate"
	},
/obj/item/storage/part_replacer/cargo,
/obj/item/storage/part_replacer/cargo,
/obj/item/storage/part_replacer/cargo,
/obj/item/storage/box/stockparts/basic,
/obj/item/storage/box/stockparts/basic,
/obj/item/storage/box/stockparts/basic,
/obj/item/storage/box/stockparts/basic,
/obj/item/storage/box/stockparts/basic,
/obj/item/storage/box/stockparts/basic,
/obj/item/storage/box/stockparts/basic,
/obj/item/storage/box/stockparts/basic,
/obj/item/storage/box/stockparts/basic,
/obj/item/storage/box/stockparts/basic,
/obj/item/storage/box/stockparts/t2,
/obj/item/storage/box/stockparts/t2,
/obj/item/assembly/igniter,
/obj/item/stock_parts/cell/high/plus{
	charge = 15000
	},
/obj/item/stock_parts/cell/high/plus{
	charge = 15000
	},
/obj/item/stock_parts/cell/high/plus{
	charge = 15000
	},
/obj/item/stock_parts/cell/high/plus{
	charge = 15000
	},
/obj/item/stock_parts/cell/high/plus{
	charge = 15000
	},
/obj/item/stock_parts/cell/high/plus{
	charge = 15000
	},
/obj/item/stock_parts/cell/high/plus{
	charge = 15000
	},
/obj/item/stock_parts/cell/high/plus{
	charge = 15000
	},
/obj/item/stock_parts/cell/high/plus{
	charge = 15000
	},
/obj/item/stock_parts/cell/high/plus{
	charge = 15000
	},
/obj/item/stock_parts/cell/high/plus{
	charge = 15000
	},
/obj/item/stock_parts/cell/high/plus{
	charge = 15000
	},
/obj/item/stock_parts/cell/high/plus{
	charge = 15000
	},
/obj/item/stock_parts/cell/high/plus{
	charge = 15000
	},
/obj/item/stock_parts/cell/high/plus{
	charge = 15000
	},
/obj/item/stock_parts/cell/high/plus{
	charge = 15000
	},
/obj/item/stock_parts/cell/high/plus{
	charge = 15000
	},
/obj/item/stock_parts/cell/high/plus{
	charge = 15000
	},
/obj/item/stock_parts/cell/high/plus{
	charge = 15000
	},
/obj/item/stock_parts/cell/high/plus{
	charge = 15000
	},
/obj/structure/catwalk/over,
/obj/structure/railing{
	dir = 8
	},
/turf/open/floor/plating/airless,
/area/ship/external)
"x" = (
/obj/machinery/power/shuttle/engine/electric{
	dir = 4
	},
/obj/structure/cable{
	icon_state = "0-4"
	},
/obj/structure/railing/corner{
	dir = 8
	},
/obj/structure/railing/corner{
	dir = 1
	},
/turf/open/floor/plating,
/area/ship/construction)
"y" = (
/obj/structure/catwalk/over,
/obj/structure/cable{
	icon_state = "2-8"
	},
/turf/open/floor/plating/airless,
/area/ship/external)
"z" = (
/obj/effect/spawner/structure/window/reinforced/shutters,
/turf/open/floor/plating,
/area/ship/construction)
"A" = (
/obj/structure/window/reinforced/spawner/west,
/obj/machinery/power/smes/shuttle/precharged{
	dir = 4
	},
/obj/structure/cable{
	icon_state = "0-8"
	},
/obj/machinery/door/window/eastleft{
	name = "Engine Access"
	},
/turf/open/floor/plating,
/area/ship/construction)
"B" = (
/obj/structure/catwalk/over,
/obj/machinery/power/terminal{
	dir = 8
	},
/obj/structure/cable,
/obj/structure/railing/corner{
	dir = 8
	},
/turf/open/floor/plating/airless,
/area/ship/external)
"C" = (
/obj/structure/catwalk/over,
/obj/structure/cable{
	icon_state = "4-8"
	},
/obj/docking_port/mobile{
	can_move_docking_ports = 1;
	dir = 2;
	dwidth = 13;
	height = 9;
	launch_status = 0;
	port_direction = 8;
	preferred_direction = 4;
	width = 13
	},
/turf/open/floor/plating/airless,
/area/ship/external)
"D" = (
/obj/structure/catwalk/over,
/obj/structure/railing{
	dir = 8
	},
/turf/open/floor/plating/airless,
/area/ship/external)
"E" = (
/obj/structure/catwalk/over,
/obj/structure/railing{
	dir = 10
	},
/turf/open/floor/plating/airless,
/area/ship/external)
"F" = (
/obj/structure/closet/crate/large{
	name = "miscellaneous crate"
	},
/obj/item/reagent_containers/food/snacks/rationpack,
/obj/item/reagent_containers/food/snacks/rationpack,
/obj/item/reagent_containers/food/snacks/rationpack,
/obj/item/reagent_containers/food/snacks/rationpack,
/obj/item/reagent_containers/food/snacks/rationpack,
/obj/item/reagent_containers/food/snacks/rationpack,
/obj/item/reagent_containers/food/snacks/rationpack,
/obj/item/reagent_containers/food/snacks/rationpack,
/obj/item/reagent_containers/food/snacks/rationpack,
/obj/item/reagent_containers/food/snacks/rationpack,
/obj/item/vending_refill/security,
/obj/item/vending_refill/security,
/obj/item/vending_refill/security,
/obj/item/storage/backpack/duffelbag/syndie/surgery,
/obj/item/reagent_containers/glass/bottle/antitoxin/sleeper,
/obj/item/reagent_containers/glass/bottle/bicaridine/sleeper,
/obj/item/reagent_containers/glass/bottle/dexalin/sleeper,
/obj/item/reagent_containers/glass/bottle/epinephrine/sleeper,
/obj/item/reagent_containers/glass/bottle/kelotane/sleeper,
/obj/item/reagent_containers/glass/bottle/morphine/sleeper,
/obj/item/storage/bag/chemistry,
/obj/structure/catwalk/over,
/obj/structure/railing{
	dir = 8
	},
/turf/open/floor/plating/airless,
/area/ship/external)
"G" = (
/obj/structure/catwalk/over,
/obj/structure/railing,
/turf/open/floor/plating/airless,
/area/ship/external)
"H" = (
/turf/template_noop,
/area/template_noop)
"I" = (
/obj/structure/closet/crate/large{
	name = "atmospherics crate"
	},
/obj/item/sbeacondrop/atmospherics/nitrogen_miner,
/obj/item/sbeacondrop/atmospherics/oxygen_miner,
/obj/item/sbeacondrop/atmospherics/plasma_miner,
/obj/item/pipe_dispenser,
/obj/item/pipe_dispenser,
/obj/item/pipe_dispenser,
/obj/structure/catwalk/over,
/turf/open/floor/plating/airless,
/area/ship/external)
"J" = (
/obj/machinery/power/shuttle/engine/electric{
	dir = 4
	},
/obj/structure/cable{
	icon_state = "0-4"
	},
/obj/structure/railing,
/obj/structure/railing{
	dir = 1
	},
/turf/open/floor/plating/airless,
/area/ship/external)
"K" = (
/obj/machinery/power/smes/shuttle/precharged{
	dir = 4
	},
/obj/structure/cable{
	icon_state = "0-8"
	},
/obj/structure/railing{
	dir = 1
	},
/obj/structure/railing,
/turf/open/floor/plating/airless,
/area/ship/external)
"L" = (
/obj/structure/cable{
	icon_state = "0-2"
	},
/obj/machinery/power/port_gen/pacman,
/obj/item/stack/sheet/mineral/plasma/fifty,
/turf/open/floor/plasteel,
/area/ship/construction)
"N" = (
/obj/structure/catwalk/over,
/obj/structure/cable{
	icon_state = "4-8"
	},
/turf/open/floor/plating/airless,
/area/ship/external)
"O" = (
/obj/structure/catwalk/over,
/obj/machinery/power/terminal{
	dir = 8
	},
/obj/structure/cable{
	icon_state = "0-2"
	},
/obj/structure/railing/corner{
	dir = 1
	},
/turf/open/floor/plating/airless,
/area/ship/external)
"R" = (
/obj/structure/catwalk/over,
/obj/structure/cable{
	icon_state = "1-8"
	},
/turf/open/floor/plating/airless,
/area/ship/external)
"S" = (
/obj/structure/closet/crate/large{
	name = "material crate"
	},
/obj/item/stack/sheet/mineral/titanium/fifty,
/obj/item/stack/sheet/mineral/titanium/fifty,
/obj/item/stack/sheet/mineral/titanium/fifty,
/obj/item/stack/sheet/mineral/titanium/fifty,
/obj/item/stack/sheet/metal/fifty,
/obj/item/stack/sheet/metal/fifty,
/obj/item/stack/sheet/metal/fifty,
/obj/item/stack/sheet/metal/fifty,
/obj/item/stack/sheet/metal/fifty,
/obj/item/stack/sheet/metal/fifty,
/obj/item/stack/sheet/metal/fifty,
/obj/item/stack/sheet/metal/fifty,
/obj/item/stack/sheet/mineral/plasma/fifty,
/obj/item/stack/sheet/mineral/plasma/fifty,
/obj/item/stack/sheet/mineral/silver/twenty,
/obj/item/stack/sheet/mineral/uranium/twenty,
/obj/item/stack/sheet/plasmarglass{
	amount = 25
	},
/obj/item/stack/sheet/titaniumglass{
	amount = 50
	},
/obj/item/stack/sheet/titaniumglass{
	amount = 50
	},
/obj/item/stack/sheet/titaniumglass{
	amount = 50
	},
/obj/item/stack/sheet/glass/fifty,
/obj/item/stack/sheet/glass/fifty,
/obj/item/stack/sheet/glass/fifty,
/obj/item/stack/sheet/glass/fifty,
/obj/item/stack/sheet/glass/fifty,
/obj/item/stack/sheet/glass/fifty,
/obj/item/stack/sheet/mineral/gold/twenty,
/obj/item/stack/sheet/mineral/diamond/five,
/obj/item/stack/cable_coil/red,
/obj/item/stack/cable_coil/red,
/obj/item/stack/cable_coil/red,
/obj/item/stack/cable_coil/red,
/obj/item/stack/cable_coil/red,
/obj/item/stack/cable_coil/red,
/obj/structure/catwalk/over,
/obj/structure/railing{
	dir = 8
	},
/turf/open/floor/plating/airless,
/area/ship/external)
"T" = (
/obj/structure/cable{
	icon_state = "2-8"
	},
/obj/structure/cable{
	icon_state = "1-8"
	},
/turf/open/floor/plasteel,
/area/ship/construction)
"U" = (
/obj/structure/cable{
	icon_state = "1-2"
	},
/obj/structure/cable{
	icon_state = "2-4"
	},
/turf/open/floor/plasteel,
/area/ship/construction)
"V" = (
/turf/closed/wall,
/area/ship/construction)
"W" = (
/obj/machinery/power/smes/shuttle/precharged{
	dir = 4
	},
/obj/structure/cable{
	icon_state = "0-8"
	},
/obj/structure/railing,
/obj/structure/railing{
	dir = 1
	},
/turf/open/floor/plating/airless,
/area/ship/external)
"X" = (
/obj/structure/catwalk/over,
/obj/structure/cable{
	icon_state = "2-4"
	},
/obj/structure/cable{
	icon_state = "4-8"
	},
/turf/open/floor/plating/airless,
/area/ship/external)
"Y" = (
/obj/structure/catwalk/over,
/obj/structure/cable,
/turf/open/floor/plating/airless,
/area/ship/external)
"Z" = (
/obj/structure/catwalk/over,
/obj/structure/railing/corner{
	dir = 1
	},
/turf/open/floor/plating/airless,
/area/ship/external)

(1,1,1) = {"
H
a
o
F
w
S
E
J
H
"}
(2,1,1) = {"
H
K
r
h
f
I
G
W
H
"}
(3,1,1) = {"
t
B
Z
h
h
h
i
O
j
"}
(4,1,1) = {"
N
H
H
D
x
D
H
H
N
"}
(5,1,1) = {"
N
H
V
V
A
V
V
H
N
"}
(6,1,1) = {"
X
Y
V
p
e
c
V
h
N
"}
(7,1,1) = {"
N
H
z
L
b
v
z
H
N
"}
(8,1,1) = {"
C
H
V
g
l
u
V
H
N
"}
(9,1,1) = {"
N
H
V
s
U
m
V
H
N
"}
(10,1,1) = {"
y
n
d
k
T
k
d
n
R
"}
(11,1,1) = {"
h
H
V
z
z
z
V
H
h
"}
(12,1,1) = {"
h
H
H
h
H
h
H
H
h
"}
(13,1,1) = {"
h
h
h
h
h
h
h
h
h
"}
