//MAP CONVERTED BY dmm2tgm.py THIS HEADER COMMENT PREVENTS RECONVERSION, DO NOT REMOVE
"a" = (
/obj/machinery/power/smes/shuttle/precharged{
	dir = 4
	},
/obj/structure/cable{
	icon_state = "0-8"
	},
/obj/structure/railing,
/obj/structure/railing{
	dir = 1
	},
/turf/open/floor/plating/airless,
/area/ship/external)
"b" = (
/obj/structure/cable{
	icon_state = "0-2"
	},
/obj/machinery/power/port_gen/pacman,
/obj/item/stack/sheet/mineral/plasma/fifty,
/turf/open/floor/iron,
/area/ship/construction)
"c" = (
/obj/structure/catwalk/over,
/obj/structure/cable{
	icon_state = "2-4"
	},
/obj/structure/cable{
	icon_state = "4-8"
	},
/turf/open/floor/plating/airless,
/area/ship/external)
"d" = (
/obj/machinery/cryopod,
/obj/machinery/computer/cryopod{
	pixel_y = -32
	},
/obj/structure/cable{
	icon_state = "4-8"
	},
/turf/open/floor/iron,
/area/ship/construction)
"e" = (
/obj/effect/spawner/structure/window/reinforced/shutters,
/turf/open/floor/plating,
/area/ship/construction)
"f" = (
/obj/structure/cable{
	icon_state = "1-4"
	},
/obj/machinery/light/small{
	dir = 8
	},
/turf/open/floor/plating,
/area/ship/construction)
"g" = (
/obj/machinery/power/shuttle/engine/electric{
	dir = 4
	},
/obj/structure/cable{
	icon_state = "0-4"
	},
/obj/structure/railing,
/obj/structure/railing{
	dir = 1
	},
/turf/open/floor/plating/airless,
/area/ship/external)
"h" = (
/obj/structure/catwalk/over,
/obj/structure/railing{
	dir = 9
	},
/turf/open/floor/plating/airless,
/area/ship/external)
"i" = (
/obj/structure/closet/crate/large{
	name = "miscellaneous crate"
	},
/obj/item/reagent_containers/food/snacks/rationpack,
/obj/item/reagent_containers/food/snacks/rationpack,
/obj/item/reagent_containers/food/snacks/rationpack,
/obj/item/reagent_containers/food/snacks/rationpack,
/obj/item/reagent_containers/food/snacks/rationpack,
/obj/item/reagent_containers/food/snacks/rationpack,
/obj/item/reagent_containers/food/snacks/rationpack,
/obj/item/reagent_containers/food/snacks/rationpack,
/obj/item/reagent_containers/food/snacks/rationpack,
/obj/item/reagent_containers/food/snacks/rationpack,
/obj/item/vending_refill/security,
/obj/item/vending_refill/security,
/obj/item/vending_refill/security,
/obj/item/storage/backpack/duffelbag/syndie/surgery,
/obj/item/reagent_containers/glass/bottle/antitoxin/sleeper,
/obj/item/reagent_containers/glass/bottle/bicaridine/sleeper,
/obj/item/reagent_containers/glass/bottle/dexalin/sleeper,
/obj/item/reagent_containers/glass/bottle/epinephrine/sleeper,
/obj/item/reagent_containers/glass/bottle/kelotane/sleeper,
/obj/item/reagent_containers/glass/bottle/morphine/sleeper,
/obj/item/storage/bag/chemistry,
/obj/structure/catwalk/over,
/obj/structure/railing{
	dir = 8
	},
/turf/open/floor/plating/airless,
/area/ship/external)
"j" = (
/obj/machinery/power/shuttle/engine/electric{
	dir = 4
	},
/obj/structure/cable{
	icon_state = "0-4"
	},
/obj/structure/railing{
	dir = 1
	},
/obj/structure/railing,
/turf/open/floor/plating/airless,
/area/ship/external)
"k" = (
/turf/closed/wall,
/area/ship/construction)
"n" = (
/obj/structure/catwalk/over,
/obj/structure/cable{
	icon_state = "1-2"
	},
/turf/open/floor/plating/airless,
/area/ship/external)
"o" = (
/obj/structure/catwalk/over,
/obj/structure/cable{
	icon_state = "4-8"
	},
/turf/open/floor/plating/airless,
/area/ship/external)
"p" = (
/obj/structure/catwalk/over,
/obj/structure/cable{
	icon_state = "1-4"
	},
/turf/open/floor/plating/airless,
/area/ship/external)
"q" = (
/obj/structure/closet/crate/large{
	name = "parts crate"
	},
/obj/item/storage/part_replacer/cargo,
/obj/item/storage/part_replacer/cargo,
/obj/item/storage/part_replacer/cargo,
/obj/item/storage/box/stockparts/basic,
/obj/item/storage/box/stockparts/basic,
/obj/item/storage/box/stockparts/basic,
/obj/item/storage/box/stockparts/basic,
/obj/item/storage/box/stockparts/basic,
/obj/item/storage/box/stockparts/basic,
/obj/item/storage/box/stockparts/basic,
/obj/item/storage/box/stockparts/basic,
/obj/item/storage/box/stockparts/basic,
/obj/item/storage/box/stockparts/basic,
/obj/item/storage/box/stockparts/t2,
/obj/item/storage/box/stockparts/t2,
/obj/item/assembly/igniter,
/obj/item/stock_parts/cell/high/plus{
	charge = 15000
	},
/obj/item/stock_parts/cell/high/plus{
	charge = 15000
	},
/obj/item/stock_parts/cell/high/plus{
	charge = 15000
	},
/obj/item/stock_parts/cell/high/plus{
	charge = 15000
	},
/obj/item/stock_parts/cell/high/plus{
	charge = 15000
	},
/obj/item/stock_parts/cell/high/plus{
	charge = 15000
	},
/obj/item/stock_parts/cell/high/plus{
	charge = 15000
	},
/obj/item/stock_parts/cell/high/plus{
	charge = 15000
	},
/obj/item/stock_parts/cell/high/plus{
	charge = 15000
	},
/obj/item/stock_parts/cell/high/plus{
	charge = 15000
	},
/obj/item/stock_parts/cell/high/plus{
	charge = 15000
	},
/obj/item/stock_parts/cell/high/plus{
	charge = 15000
	},
/obj/item/stock_parts/cell/high/plus{
	charge = 15000
	},
/obj/item/stock_parts/cell/high/plus{
	charge = 15000
	},
/obj/item/stock_parts/cell/high/plus{
	charge = 15000
	},
/obj/item/stock_parts/cell/high/plus{
	charge = 15000
	},
/obj/item/stock_parts/cell/high/plus{
	charge = 15000
	},
/obj/item/stock_parts/cell/high/plus{
	charge = 15000
	},
/obj/item/stock_parts/cell/high/plus{
	charge = 15000
	},
/obj/item/stock_parts/cell/high/plus{
	charge = 15000
	},
/obj/structure/catwalk/over,
/obj/structure/railing{
	dir = 8
	},
/obj/item/stock_parts/subspace/amplifier,
/obj/item/stock_parts/subspace/amplifier,
/obj/item/stock_parts/subspace/transmitter,
/obj/item/stock_parts/subspace/transmitter,
/obj/item/stock_parts/subspace/crystal,
/turf/open/floor/plating/airless,
/area/ship/external)
"r" = (
/obj/structure/closet/crate/large{
	name = "material crate"
	},
/obj/item/stack/sheet/mineral/titanium/fifty,
/obj/item/stack/sheet/mineral/titanium/fifty,
/obj/item/stack/sheet/mineral/titanium/fifty,
/obj/item/stack/sheet/mineral/titanium/fifty,
/obj/item/stack/sheet/metal/fifty,
/obj/item/stack/sheet/metal/fifty,
/obj/item/stack/sheet/metal/fifty,
/obj/item/stack/sheet/metal/fifty,
/obj/item/stack/sheet/metal/fifty,
/obj/item/stack/sheet/metal/fifty,
/obj/item/stack/sheet/metal/fifty,
/obj/item/stack/sheet/metal/fifty,
/obj/item/stack/sheet/mineral/plasma/fifty,
/obj/item/stack/sheet/mineral/plasma/fifty,
/obj/item/stack/sheet/mineral/silver/twenty,
/obj/item/stack/sheet/mineral/uranium/twenty,
/obj/item/stack/sheet/plasmarglass{
	amount = 25
	},
/obj/item/stack/sheet/titaniumglass{
	amount = 50
	},
/obj/item/stack/sheet/titaniumglass{
	amount = 50
	},
/obj/item/stack/sheet/titaniumglass{
	amount = 50
	},
/obj/item/stack/sheet/glass/fifty,
/obj/item/stack/sheet/glass/fifty,
/obj/item/stack/sheet/glass/fifty,
/obj/item/stack/sheet/glass/fifty,
/obj/item/stack/sheet/glass/fifty,
/obj/item/stack/sheet/glass/fifty,
/obj/item/stack/sheet/mineral/gold/twenty,
/obj/item/stack/sheet/mineral/diamond/five,
/obj/item/stack/cable_coil/red,
/obj/item/stack/cable_coil/red,
/obj/item/stack/cable_coil/red,
/obj/item/stack/cable_coil/red,
/obj/item/stack/cable_coil/red,
/obj/item/stack/cable_coil/red,
/obj/structure/catwalk/over,
/obj/structure/railing{
	dir = 8
	},
/turf/open/floor/plating/airless,
/area/ship/external)
"s" = (
/obj/item/construction/rcd/combat,
/obj/item/construction/rcd/combat,
/obj/item/construction/rcd/combat,
/obj/item/construction/rcd/combat,
/obj/item/construction/rcd/combat,
/obj/structure/closet/crate/large{
	name = "equipment crate"
	},
/obj/item/storage/toolbox/mechanical,
/obj/item/storage/toolbox/mechanical,
/obj/item/storage/toolbox/mechanical,
/obj/item/storage/toolbox/mechanical,
/obj/item/storage/toolbox/mechanical,
/obj/item/clothing/shoes/magboots,
/obj/item/clothing/shoes/magboots,
/obj/item/clothing/shoes/magboots,
/obj/item/clothing/shoes/magboots,
/obj/item/clothing/shoes/magboots,
/obj/item/clothing/suit/space/hardsuit/mining/independent,
/obj/item/clothing/suit/space/hardsuit/mining/independent,
/obj/item/clothing/suit/space/hardsuit/mining/independent,
/obj/item/clothing/suit/space/hardsuit/mining/independent,
/obj/item/clothing/suit/space/hardsuit/mining/independent,
/obj/item/clothing/mask/gas,
/obj/item/clothing/mask/gas,
/obj/item/clothing/mask/gas,
/obj/item/clothing/mask/gas,
/obj/item/clothing/mask/gas,
/obj/item/tank/internals/oxygen,
/obj/item/tank/internals/oxygen,
/obj/item/tank/internals/oxygen,
/obj/item/tank/internals/oxygen,
/obj/item/tank/internals/oxygen,
/obj/item/tank/jetpack/oxygen,
/obj/item/tank/jetpack/oxygen,
/obj/item/tank/jetpack/oxygen,
/obj/item/tank/jetpack/oxygen,
/obj/item/tank/jetpack/oxygen,
/obj/item/clothing/gloves/color/yellow,
/obj/item/clothing/gloves/color/yellow,
/obj/item/clothing/gloves/color/yellow,
/obj/item/clothing/gloves/color/yellow,
/obj/machinery/light/small,
/obj/item/clothing/gloves/color/yellow,
/obj/structure/cable{
	icon_state = "1-8"
	},
/turf/open/floor/iron,
/area/ship/construction)
"t" = (
/obj/structure/cable{
	icon_state = "1-2"
	},
/obj/structure/cable{
	icon_state = "2-4"
	},
/turf/open/floor/iron,
/area/ship/construction)
"v" = (
/obj/structure/catwalk/over,
/obj/structure/cable{
	icon_state = "2-8"
	},
/turf/open/floor/plating/airless,
/area/ship/external)
"w" = (
/turf/template_noop,
/area/template_noop)
"x" = (
/obj/structure/catwalk/over,
/obj/machinery/power/terminal{
	dir = 8
	},
/obj/structure/cable,
/obj/structure/railing/corner{
	dir = 8
	},
/turf/open/floor/plating/airless,
/area/ship/external)
"y" = (
/obj/structure/window/reinforced/spawner/west,
/obj/machinery/power/smes/shuttle/precharged{
	dir = 4
	},
/obj/structure/cable{
	icon_state = "0-8"
	},
/obj/machinery/door/window/eastleft{
	name = "Engine Access"
	},
/turf/open/floor/plating,
/area/ship/construction)
"z" = (
/obj/structure/cable{
	icon_state = "0-8"
	},
/obj/structure/cable{
	icon_state = "4-8"
	},
/obj/machinery/power/smes/engineering,
/turf/open/floor/iron,
/area/ship/construction)
"A" = (
/obj/structure/catwalk/over,
/obj/structure/railing/corner{
	dir = 8
	},
/turf/open/floor/plating/airless,
/area/ship/external)
"B" = (
/obj/machinery/light/small{
	dir = 1
	},
/obj/machinery/computer/helm,
/turf/open/floor/iron,
/area/ship/construction)
"C" = (
/obj/machinery/power/smes/shuttle/precharged{
	dir = 4
	},
/obj/structure/cable{
	icon_state = "0-8"
	},
/obj/structure/railing{
	dir = 1
	},
/obj/structure/railing,
/turf/open/floor/plating/airless,
/area/ship/external)
"D" = (
/obj/structure/catwalk/over,
/obj/structure/railing/corner{
	dir = 1
	},
/turf/open/floor/plating/airless,
/area/ship/external)
"E" = (
/obj/structure/cable{
	icon_state = "0-2"
	},
/obj/machinery/power/apc/auto_name/north,
/obj/structure/closet/secure_closet/engineering_chief,
/obj/item/clothing/mask/gas,
/obj/item/tank/internals/oxygen,
/obj/item/clothing/suit/space/hardsuit/engine/elite,
/obj/item/areaeditor/shuttle,
/turf/open/floor/iron,
/area/ship/construction)
"F" = (
/obj/structure/cable{
	icon_state = "1-2"
	},
/turf/open/floor/iron,
/area/ship/construction)
"G" = (
/obj/structure/closet/crate/large{
	name = "circuitry crate"
	},
/obj/item/circuitboard/computer/communications,
/obj/item/circuitboard/computer/cargo/express,
/obj/item/circuitboard/machine/autolathe,
/obj/item/circuitboard/machine/microwave,
/obj/item/circuitboard/machine/ore_silo,
/obj/item/circuitboard/machine/pacman,
/obj/item/circuitboard/machine/pacman,
/obj/item/circuitboard/machine/pacman/uranium,
/obj/item/circuitboard/machine/pacman/uranium,
/obj/item/circuitboard/machine/pacman/diamond,
/obj/item/circuitboard/machine/shuttle/heater,
/obj/item/circuitboard/machine/shuttle/heater,
/obj/item/circuitboard/machine/shuttle/heater,
/obj/item/circuitboard/machine/shuttle/heater,
/obj/item/circuitboard/machine/shuttle/heater,
/obj/item/circuitboard/machine/shuttle/heater,
/obj/item/circuitboard/machine/shuttle/smes,
/obj/item/circuitboard/machine/shuttle/smes,
/obj/item/circuitboard/machine/shuttle/smes,
/obj/item/circuitboard/machine/shuttle/smes,
/obj/item/circuitboard/machine/shuttle/smes,
/obj/item/circuitboard/machine/shuttle/smes,
/obj/item/circuitboard/machine/shuttle/smes,
/obj/item/circuitboard/machine/shuttle/engine/electric,
/obj/item/circuitboard/machine/shuttle/engine/electric,
/obj/item/circuitboard/machine/shuttle/engine/electric,
/obj/item/circuitboard/machine/shuttle/engine/electric,
/obj/item/circuitboard/machine/shuttle/engine/electric,
/obj/item/circuitboard/machine/shuttle/engine/electric,
/obj/item/circuitboard/machine/shuttle/engine/plasma,
/obj/item/circuitboard/machine/shuttle/engine/plasma,
/obj/item/circuitboard/machine/shuttle/engine/plasma,
/obj/item/circuitboard/machine/shuttle/engine/plasma,
/obj/item/circuitboard/machine/shuttle/engine/plasma,
/obj/item/circuitboard/machine/shuttle/engine/plasma,
/obj/item/circuitboard/machine/thermomachine/freezer,
/obj/item/circuitboard/machine/thermomachine/heater,
/obj/item/circuitboard/machine/circulator,
/obj/item/circuitboard/machine/circulator,
/obj/item/circuitboard/computer/selling_pad_control,
/obj/item/circuitboard/machine/selling_pad,
/obj/item/storage/box/rndboards{
	name = "research boards";
	desc = "A box containing circuit boards for establishing research and development equipment."
	},
/obj/item/circuitboard/machine/smes,
/obj/item/circuitboard/machine/smes,
/obj/item/circuitboard/machine/smes,
/obj/item/circuitboard/machine/sleeper,
/obj/item/circuitboard/machine/sleeper,
/obj/item/circuitboard/machine/sleeper,
/obj/structure/catwalk/over,
/obj/item/circuitboard/machine/generator,
/obj/item/circuitboard/machine/power_compressor,
/obj/item/circuitboard/machine/power_turbine,
/obj/item/circuitboard/computer/turbine_computer,
/obj/item/circuitboard/machine/ore_redemption,
/turf/open/floor/plating/airless,
/area/ship/external)
"H" = (
/obj/structure/cable,
/obj/machinery/power/terminal,
/turf/open/floor/iron,
/area/ship/construction)
"I" = (
/obj/structure/catwalk/over,
/turf/open/floor/plating/airless,
/area/ship/external)
"J" = (
/obj/structure/catwalk/over,
/obj/structure/railing{
	dir = 8
	},
/turf/open/floor/plating/airless,
/area/ship/external)
"K" = (
/obj/structure/catwalk/over,
/obj/structure/railing,
/turf/open/floor/plating/airless,
/area/ship/external)
"L" = (
/obj/structure/catwalk/over,
/obj/structure/cable,
/obj/machinery/power/apc/auto_name/south,
/turf/open/floor/plating/airless,
/area/ship/external)
"M" = (
/obj/machinery/airalarm/all_access{
	dir = 4;
	pixel_x = -24
	},
/obj/structure/closet/crate/medical,
/obj/item/storage/firstaid/brute,
/obj/item/storage/firstaid/fire,
/obj/item/storage/firstaid/medical,
/obj/item/defibrillator/loaded,
/turf/open/floor/plating,
/area/ship/construction)
"O" = (
/obj/structure/catwalk/over,
/obj/structure/cable{
	icon_state = "2-4"
	},
/turf/open/floor/plating/airless,
/area/ship/external)
"P" = (
/obj/machinery/power/shuttle/engine/electric{
	dir = 4
	},
/obj/structure/cable{
	icon_state = "0-4"
	},
/obj/structure/railing/corner{
	dir = 8
	},
/obj/structure/railing/corner{
	dir = 1
	},
/turf/open/floor/plating,
/area/ship/construction)
"Q" = (
/obj/structure/cable{
	icon_state = "2-8"
	},
/obj/structure/cable{
	icon_state = "1-8"
	},
/turf/open/floor/iron,
/area/ship/construction)
"R" = (
/obj/structure/catwalk/over,
/obj/structure/railing{
	dir = 1
	},
/turf/open/floor/plating/airless,
/area/ship/external)
"S" = (
/obj/structure/catwalk/over,
/obj/structure/cable{
	icon_state = "1-8"
	},
/turf/open/floor/plating/airless,
/area/ship/external)
"T" = (
/obj/structure/closet/crate/large{
	name = "atmospherics crate"
	},
/obj/item/sbeacondrop/atmospherics/nitrogen_miner,
/obj/item/sbeacondrop/atmospherics/oxygen_miner,
/obj/item/sbeacondrop/atmospherics/plasma_miner,
/obj/item/pipe_dispenser,
/obj/item/pipe_dispenser,
/obj/item/pipe_dispenser,
/obj/structure/catwalk/over,
/obj/item/paper{
	info = "DO NOT ACTIVATE THE GAS MINER TELEPORTERS OUTSIDE OF THE APPROPRIATE TANKS YOU FUCKING DIMWITS!!";
	color = "#ff0000";
	desc = "Seems important. That's why it's red."
	},
/obj/item/holosign_creator/atmos,
/turf/open/floor/plating/airless,
/area/ship/external)
"U" = (
/obj/structure/cable{
	icon_state = "0-2"
	},
/obj/machinery/power/terminal{
	dir = 8
	},
/turf/open/floor/plating,
/area/ship/construction)
"V" = (
/obj/structure/catwalk/over,
/obj/structure/cable{
	icon_state = "4-8"
	},
/obj/docking_port/mobile{
	can_move_docking_ports = 1;
	dir = 2;
	dwidth = 13;
	height = 9;
	launch_status = 0;
	port_direction = 8;
	preferred_direction = 4;
	width = 13
	},
/turf/open/floor/plating/airless,
/area/ship/external)
"W" = (
/obj/structure/catwalk/over,
/obj/structure/railing{
	dir = 10
	},
/turf/open/floor/plating/airless,
/area/ship/external)
"X" = (
/obj/machinery/door/airlock/external/glass,
/obj/structure/fans/tiny,
/obj/structure/cable{
	icon_state = "1-2"
	},
/turf/open/floor/plating,
/area/ship/construction)
"Y" = (
/turf/open/floor/iron,
/area/ship/construction)
"Z" = (
/obj/structure/catwalk/over,
/obj/machinery/power/terminal{
	dir = 8
	},
/obj/structure/cable{
	icon_state = "0-2"
	},
/obj/structure/railing/corner{
	dir = 1
	},
/turf/open/floor/plating/airless,
/area/ship/external)

(1,1,1) = {"
w
j
h
i
q
r
W
g
w
"}
(2,1,1) = {"
w
C
R
I
G
T
K
a
w
"}
(3,1,1) = {"
O
x
D
I
I
I
A
Z
p
"}
(4,1,1) = {"
o
w
w
J
P
J
w
w
o
"}
(5,1,1) = {"
o
w
k
k
y
k
k
w
o
"}
(6,1,1) = {"
c
L
k
M
U
f
k
I
o
"}
(7,1,1) = {"
o
w
e
b
H
z
e
w
o
"}
(8,1,1) = {"
V
w
k
B
Y
d
k
w
o
"}
(9,1,1) = {"
o
w
k
E
t
s
k
w
o
"}
(10,1,1) = {"
v
n
X
F
Q
F
X
n
S
"}
(11,1,1) = {"
I
w
k
e
e
e
k
w
I
"}
(12,1,1) = {"
I
w
w
I
w
I
w
w
I
"}
(13,1,1) = {"
I
I
I
I
I
I
I
I
I
"}
