//MAP CONVERTED BY dmm2tgm.py THIS HEADER COMMENT PREVENTS RECONVERSION, DO NOT REMOVE
"a" = (
/turf/open/space/basic,
/area/space)
"b" = (
/obj/machinery/cryopod,
/obj/effect/turf_decal/siding/thinplating/dark,
/turf/open/floor/iron/textured_large,
/area/ship/engineering)
"c" = (
/obj/machinery/door/firedoor/border_only{
	dir = 4
	},
/obj/item/ammo_casing/spent,
/turf/open/floor/iron/herringbone,
/area/ship/engineering)
"d" = (
/obj/machinery/door/airlock/engineering{
	name = "Engineering"
	},
/obj/machinery/door/firedoor,
/turf/open/floor/iron/dark/small,
/area/ship/engineering)
"e" = (
/obj/machinery/power/terminal{
	dir = 8
	},
/obj/structure/cable{
	icon_state = "1-4"
	},
/obj/structure/cable{
	icon_state = "0-4"
	},
/obj/structure/cable{
	icon_state = "2-4"
	},
/turf/open/floor/plating,
/area/ship/engineering)
"f" = (
/obj/item/restraints/handcuffs,
/obj/effect/decal/cleanable/blood/tracks{
	dir = 5
	},
/turf/open/floor/iron/herringbone,
/area/ship/engineering)
"g" = (
/obj/effect/turf_decal/siding/thinplating/dark{
	dir = 1
	},
/obj/structure/chair/comfy/shuttle{
	dir = 4
	},
/obj/structure/window/reinforced/survival_pod{
	dir = 4
	},
/obj/item/restraints/handcuffs,
/turf/open/floor/iron/textured_large,
/area/ship/engineering)
"i" = (
/obj/item/restraints/handcuffs,
/turf/open/floor/iron/herringbone,
/area/ship/engineering)
"k" = (
/obj/machinery/power/smes,
/obj/structure/cable{
	icon_state = "0-8"
	},
/obj/effect/turf_decal/siding/thinplating/dark{
	dir = 10
	},
/turf/open/floor/iron/textured_large,
/area/ship/engineering)
"l" = (
/obj/structure/window/plasma/reinforced/plastitanium,
/obj/structure/grille,
/obj/machinery/door/poddoor{
	name = "Window Blast Door";
	id = "slammer_ext_window"
	},
/turf/open/floor/plating,
/area/ship/engineering)
"m" = (
/obj/structure/sign/solgov_seal{
	pixel_y = 0
	},
/turf/closed/wall/mineral/plastitanium/nodiagonal,
/area/ship/engineering)
"n" = (
/obj/machinery/airalarm/directional/east,
/obj/machinery/autolathe,
/obj/effect/turf_decal/siding/thinplating/dark{
	dir = 8
	},
/turf/open/floor/iron/textured_large,
/area/ship/engineering)
"o" = (
/obj/effect/decal/cleanable/blood,
/obj/effect/mob_spawn/human/corpse/solgovprisoner,
/obj/item/kitchen/knife/shiv,
/turf/open/floor/iron/herringbone,
/area/ship/engineering)
"p" = (
/obj/effect/turf_decal/siding/thinplating/dark{
	dir = 1
	},
/obj/structure/window/reinforced/survival_pod{
	dir = 4
	},
/obj/structure/sign/poster/solgov/solgov_logo{
	pixel_y = -32
	},
/obj/machinery/door/firedoor/border_only{
	dir = 4
	},
/obj/structure/closet/crate/freezer/food,
/obj/effect/spawner/lootdrop/three_course_meal,
/obj/effect/spawner/lootdrop/three_course_meal,
/obj/effect/spawner/lootdrop/three_course_meal,
/obj/item/reagent_containers/food/drinks/waterbottle/large,
/obj/item/reagent_containers/food/drinks/waterbottle/large,
/obj/item/reagent_containers/food/drinks/waterbottle/large,
/obj/item/reagent_containers/food/drinks/waterbottle/large,
/obj/item/reagent_containers/food/drinks/waterbottle/large,
/obj/item/reagent_containers/food/drinks/waterbottle/large,
/obj/item/reagent_containers/food/drinks/waterbottle/large,
/obj/item/reagent_containers/food/drinks/waterbottle/large,
/obj/item/reagent_containers/food/drinks/waterbottle/large,
/turf/open/floor/iron/textured_large,
/area/ship/engineering)
"q" = (
/obj/effect/turf_decal/siding/thinplating/dark{
	dir = 1
	},
/obj/structure/ore_box,
/turf/open/floor/iron/textured_large,
/area/ship/engineering)
"r" = (
/obj/item/gun/ballistic/automatic/pistol/m1911,
/obj/machinery/power/terminal{
	dir = 8
	},
/obj/structure/cable{
	icon_state = "1-2"
	},
/obj/structure/cable,
/obj/effect/decal/cleanable/blood/drip,
/turf/open/floor/plating,
/area/ship/engineering)
"s" = (
/obj/effect/decal/cleanable/blood/tracks,
/obj/item/ammo_casing/spent,
/turf/open/floor/iron/herringbone,
/area/ship/engineering)
"t" = (
/obj/effect/turf_decal/siding/thinplating/dark,
/obj/structure/chair/comfy/shuttle{
	dir = 4
	},
/obj/structure/window/reinforced/survival_pod{
	dir = 4
	},
/obj/machinery/airalarm/directional/north,
/turf/open/floor/iron/textured_large,
/area/ship/engineering)
"u" = (
/obj/structure/rack,
/obj/machinery/vending/wallmed{
	pixel_y = -27
	},
/obj/item/storage/toolbox/emergency,
/obj/item/storage/box/handcuffs,
/turf/open/floor/iron/smooth_large,
/area/ship/engineering)
"v" = (
/obj/effect/decal/cleanable/blood/splatter,
/obj/machinery/light/floor,
/turf/open/floor/iron/herringbone,
/area/ship/engineering)
"w" = (
/obj/machinery/power/port_gen/pacman,
/obj/structure/cable,
/obj/item/stack/sheet/mineral/plasma/fifty,
/obj/machinery/button/door{
	name = "Engine Shutters Control";
	pixel_x = 25;
	id = "slammer_engine"
	},
/obj/effect/turf_decal/siding/thinplating/dark{
	dir = 9
	},
/turf/open/floor/iron/textured_large,
/area/ship/engineering)
"x" = (
/obj/effect/decal/cleanable/blood/drip,
/obj/item/ammo_casing/spent,
/turf/open/floor/iron/herringbone,
/area/ship/engineering)
"y" = (
/obj/structure/cable{
	icon_state = "0-8"
	},
/obj/structure/window/reinforced/survival_pod{
	dir = 8
	},
/obj/machinery/door/window/survival_pod{
	dir = 4;
	name = "Engine Access"
	},
/obj/machinery/power/smes/shuttle/precharged{
	dir = 4
	},
/obj/machinery/door/poddoor/shutters{
	name = "Engineering Engine Shutters";
	id = "slammer_engine"
	},
/turf/open/floor/plating,
/area/ship/engineering)
"z" = (
/obj/machinery/cryopod,
/obj/machinery/computer/cryopod{
	pixel_x = -32
	},
/obj/effect/turf_decal/siding/thinplating/dark,
/turf/open/floor/iron/textured_large,
/area/ship/engineering)
"A" = (
/obj/structure/cable{
	icon_state = "0-2"
	},
/obj/machinery/power/terminal{
	dir = 1
	},
/obj/effect/decal/cleanable/blood/drip,
/turf/open/floor/plating,
/area/ship/engineering)
"B" = (
/obj/item/ammo_casing/spent,
/obj/item/ammo_casing/spent,
/obj/machinery/light/floor,
/turf/open/floor/iron/herringbone,
/area/ship/engineering)
"C" = (
/obj/machinery/computer/helm{
	dir = 8
	},
/turf/open/floor/iron/smooth_large,
/area/ship/engineering)
"D" = (
/obj/machinery/computer/autopilot,
/obj/structure/extinguisher_cabinet{
	pixel_y = 27
	},
/turf/open/floor/iron/smooth_large,
/area/ship/engineering)
"E" = (
/obj/effect/turf_decal/siding/thinplating/dark,
/obj/structure/chair/comfy/shuttle{
	dir = 4
	},
/obj/structure/window/reinforced/survival_pod{
	dir = 4
	},
/obj/machinery/door/firedoor/border_only{
	dir = 4
	},
/obj/structure/sign/poster/solgov/solgov_enlist{
	pixel_y = 32
	},
/turf/open/floor/iron/textured_large,
/area/ship/engineering)
"F" = (
/obj/machinery/power/shuttle/engine/electric{
	dir = 4
	},
/obj/structure/cable{
	icon_state = "0-4"
	},
/turf/open/floor/plating/airless,
/area/ship/engineering)
"G" = (
/obj/machinery/portable_atmospherics/canister/air,
/obj/effect/turf_decal/siding/thinplating/dark{
	dir = 8
	},
/turf/open/floor/iron/textured_large,
/area/ship/engineering)
"H" = (
/obj/structure/cable{
	icon_state = "1-2"
	},
/obj/structure/cable,
/obj/machinery/power/apc/auto_name/west,
/turf/open/floor/plating,
/area/ship/engineering)
"I" = (
/obj/structure/closet/emcloset/wall{
	pixel_y = 27
	},
/obj/machinery/power/terminal{
	dir = 8
	},
/obj/structure/cable{
	icon_state = "0-2"
	},
/obj/item/ammo_box/c45,
/obj/machinery/light/small{
	dir = 1
	},
/turf/open/floor/plating,
/area/ship/engineering)
"J" = (
/obj/effect/turf_decal/siding/thinplating/dark{
	dir = 1
	},
/obj/structure/closet/crate/cargo/mining{
	name = "mining supplies crate"
	},
/obj/item/mining_scanner,
/obj/item/mining_scanner,
/obj/item/mining_scanner,
/obj/item/pickaxe,
/obj/item/pickaxe,
/obj/item/pickaxe,
/obj/item/storage/bag/ore,
/obj/item/storage/bag/ore,
/obj/item/storage/bag/ore,
/turf/open/floor/iron/textured_large,
/area/ship/engineering)
"K" = (
/obj/structure/window/reinforced/survival_pod{
	dir = 8
	},
/obj/effect/turf_decal/siding/thinplating/dark{
	dir = 8
	},
/obj/machinery/door/firedoor/border_only{
	dir = 8
	},
/obj/machinery/suit_storage_unit/standard_unit,
/turf/open/floor/iron/smooth_large,
/area/ship/engineering)
"L" = (
/obj/effect/decal/cleanable/blood,
/obj/machinery/door/firedoor/border_only{
	dir = 4
	},
/obj/item/ammo_casing/spent,
/turf/open/floor/iron/herringbone,
/area/ship/engineering)
"M" = (
/obj/effect/turf_decal/siding/thinplating/dark,
/obj/item/clothing/suit/space,
/obj/item/clothing/suit/space,
/obj/item/clothing/head/helmet/space,
/obj/item/clothing/head/helmet/space,
/obj/structure/closet/crate/preopen{
	name = "space suit crate"
	},
/turf/open/floor/iron/textured_large,
/area/ship/engineering)
"N" = (
/obj/effect/decal/cleanable/blood,
/obj/structure/chair/comfy/shuttle{
	dir = 4
	},
/obj/effect/mob_spawn/human/corpse/police,
/obj/item/paper/crumpled/bloody{
	info = "You'd think they would make a bigger bus, with more officers with the amount of prisoners we always deliver. I almost feel like every one of them is staring daggers into the back of my head while I pilot this heap of junk. Not to mention the smart fucks who manufactured this ship left access on all the doors, so who knows what happens next. I really don't think it'll make it easier when they'll realize we'll put them to work in the mines either, they're all curious about the mining gear we have in the back, but I just keep telling them it's for emergency. They'll learn about it after we hand them off to the officers on the minin-~";
	name = "Concerned Note"
	},
/obj/item/pen,
/turf/open/floor/iron/smooth_large,
/area/ship/engineering)
"O" = (
/obj/effect/turf_decal/siding/thinplating/dark{
	dir = 8
	},
/obj/structure/window/reinforced/survival_pod{
	dir = 8
	},
/obj/structure/table/reinforced,
/obj/machinery/door/firedoor/border_only{
	dir = 8
	},
/obj/machinery/button/door{
	name = "Engine Shutters Control";
	id = "slammer_engine";
	pixel_y = 7
	},
/obj/machinery/button/door{
	pixel_y = -3;
	name = "External Window Control";
	id = "slammer_ext_window"
	},
/turf/open/floor/iron/smooth_large,
/area/ship/engineering)
"P" = (
/obj/effect/mob_spawn/human/corpse/police,
/obj/effect/decal/cleanable/blood,
/obj/machinery/power/terminal{
	dir = 8
	},
/obj/structure/cable,
/obj/machinery/light/small,
/turf/open/floor/plating,
/area/ship/engineering)
"Q" = (
/obj/effect/turf_decal/siding/thinplating/dark,
/obj/structure/chair/comfy/shuttle{
	dir = 4
	},
/obj/structure/window/reinforced/survival_pod{
	dir = 4
	},
/obj/effect/mob_spawn/human/corpse/solgovprisoner,
/obj/effect/decal/cleanable/blood,
/turf/open/floor/iron/textured_large,
/area/ship/engineering)
"R" = (
/obj/effect/turf_decal/siding/thinplating/dark,
/obj/structure/chair/comfy/shuttle{
	dir = 4
	},
/obj/structure/window/reinforced/survival_pod{
	dir = 4
	},
/obj/item/restraints/handcuffs,
/turf/open/floor/iron/textured_large,
/area/ship/engineering)
"T" = (
/obj/effect/turf_decal/siding/thinplating/dark{
	dir = 8
	},
/obj/machinery/door/window/survival_pod{
	dir = 8;
	name = "Cockpit"
	},
/obj/item/kitchen/knife/shiv,
/obj/machinery/door/firedoor/border_only{
	dir = 8
	},
/obj/effect/decal/cleanable/blood/splatter,
/obj/machinery/light/floor,
/turf/open/floor/iron/smooth_large,
/area/ship/engineering)
"U" = (
/obj/effect/turf_decal/siding/thinplating/dark,
/obj/structure/window/reinforced/survival_pod{
	dir = 4
	},
/obj/machinery/door/firedoor/border_only{
	dir = 4
	},
/obj/machinery/cryopod,
/turf/open/floor/iron/textured_large,
/area/ship/engineering)
"V" = (
/obj/effect/turf_decal/siding/thinplating/dark{
	dir = 1
	},
/obj/structure/chair/comfy/shuttle{
	dir = 4
	},
/obj/structure/window/reinforced/survival_pod{
	dir = 4
	},
/obj/machinery/firealarm/south,
/turf/open/floor/iron/textured_large,
/area/ship/engineering)
"W" = (
/obj/effect/turf_decal/siding/thinplating/dark{
	dir = 5
	},
/obj/structure/chair/comfy/shuttle{
	dir = 4
	},
/obj/structure/window/reinforced/survival_pod{
	dir = 4
	},
/obj/structure/sign/warning/vacuum/external{
	pixel_y = -32
	},
/obj/machinery/door/firedoor/border_only{
	dir = 4
	},
/obj/effect/mob_spawn/human/corpse/solgovprisoner,
/obj/effect/decal/cleanable/blood,
/turf/open/floor/iron/textured_large,
/area/ship/engineering)
"X" = (
/turf/closed/wall/mineral/plastitanium,
/area/ship/engineering)
"Y" = (
/obj/structure/fans/tiny,
/obj/machinery/door/airlock/external/glass,
/obj/effect/decal/cleanable/blood/tracks,
/obj/docking_port/mobile{
	callTime = 250;
	launch_status = 0;
	name = "Slammer-Class";
	port_direction = 4;
	preferred_direction = 8
	},
/turf/open/floor/plating,
/area/ship/engineering)
"Z" = (
/turf/closed/wall/mineral/plastitanium/nodiagonal,
/area/ship/engineering)

(1,1,1) = {"
X
a
a
a
a
a
a
a
X
"}
(2,1,1) = {"
Z
X
a
a
a
a
a
X
Z
"}
(3,1,1) = {"
Z
Z
F
F
Z
F
F
Z
Z
"}
(4,1,1) = {"
Z
Z
y
y
Z
y
y
Z
Z
"}
(5,1,1) = {"
X
Z
I
e
H
r
P
Z
X
"}
(6,1,1) = {"
a
m
n
k
A
w
G
m
a
"}
(7,1,1) = {"
a
X
Z
Z
d
Z
Z
X
a
"}
(8,1,1) = {"
a
a
Z
z
x
J
Z
a
a
"}
(9,1,1) = {"
a
a
l
b
v
q
l
a
a
"}
(10,1,1) = {"
a
a
Z
U
c
p
Z
a
a
"}
(11,1,1) = {"
a
a
l
R
o
g
l
a
a
"}
(12,1,1) = {"
a
a
Z
t
i
V
Z
a
a
"}
(13,1,1) = {"
a
a
l
Q
B
g
l
a
a
"}
(14,1,1) = {"
a
a
Z
E
L
W
Z
a
a
"}
(15,1,1) = {"
a
a
l
M
f
s
Y
a
a
"}
(16,1,1) = {"
a
a
m
K
T
O
m
a
a
"}
(17,1,1) = {"
a
a
Z
D
N
u
Z
a
a
"}
(18,1,1) = {"
a
a
l
l
C
l
l
a
a
"}
(19,1,1) = {"
a
a
a
l
l
l
a
a
a
"}
