//MAP CONVERTED BY dmm2tgm.py THIS HEADER COMMENT PREVENTS RECONVERSION, DO NOT REMOVE
"ad" = (
/obj/structure/table/wood,
/obj/machinery/microwave,
/obj/effect/spawner/lootdrop/donkpockets,
/obj/effect/spawner/lootdrop/donkpockets,
/obj/machinery/firealarm{
	pixel_y = -24
	},
/obj/effect/decal/cleanable/dirt/dust,
/obj/effect/turf_decal/siding/wood{
	dir = 1
	},
/turf/open/floor/wood,
/area/ship/crew/canteen)
"aj" = (
/obj/structure/extinguisher_cabinet{
	pixel_x = 26
	},
/turf/closed/wall/mineral/titanium/nodiagonal,
/area/ship/engineering)
"aF" = (
/obj/machinery/button/door{
	id = "pocketrocket_bridge_window";
	name = "Bridge Exterior Windows Shutters Control";
	pixel_y = 26;
	pixel_x = 6
	},
/obj/machinery/button/door{
	id = "pocketrocket_window";
	name = "Exterior Windows Shutters Control";
	pixel_y = 26;
	pixel_x = -6
	},
/obj/effect/decal/cleanable/dirt/dust,
/turf/open/floor/carpet,
/area/ship/bridge)
"bU" = (
/turf/closed/wall/mineral/titanium/nodiagonal,
/area/ship/engineering)
"cg" = (
/obj/structure/cable{
	icon_state = "1-2"
	},
/obj/machinery/door/airlock/public/glass{
	name = "Canteen"
	},
/obj/machinery/atmospherics/pipe/simple/supply/hidden/layer4,
/obj/machinery/atmospherics/pipe/simple/scrubbers/hidden/layer2,
/obj/machinery/door/firedoor,
/obj/effect/turf_decal/siding/wood{
	dir = 1
	},
/turf/open/floor/iron/dark/textured_large,
/area/ship/crew/canteen)
"cK" = (
/obj/machinery/atmospherics/pipe/simple/scrubbers/hidden/layer2{
	dir = 4
	},
/turf/closed/wall/mineral/titanium/nodiagonal,
/area/ship/engineering)
"cV" = (
/turf/open/floor/iron,
/area/ship/cargo)
"da" = (
/obj/machinery/atmospherics/components/unary/vent_pump/on/layer4,
/obj/structure/cable{
	icon_state = "1-8"
	},
/obj/structure/cable{
	icon_state = "1-2"
	},
/obj/effect/turf_decal/industrial/caution,
/obj/effect/turf_decal/siding/thinplating/dark{
	dir = 1
	},
/turf/open/floor/iron,
/area/ship/engineering)
"dZ" = (
/obj/effect/decal/cleanable/dirt,
/turf/open/floor/iron/grimy,
/area/ship/crew)
"eR" = (
/obj/effect/turf_decal/siding/thinplating/dark{
	dir = 1
	},
/obj/effect/decal/cleanable/dirt,
/turf/open/floor/iron,
/area/ship/engineering)
"fe" = (
/obj/structure/cable{
	icon_state = "4-8"
	},
/obj/machinery/door/airlock/command{
	name = "Bridge"
	},
/obj/machinery/atmospherics/pipe/simple/supply/hidden/layer4{
	dir = 8
	},
/obj/machinery/atmospherics/pipe/simple/scrubbers/hidden/layer2{
	dir = 4
	},
/obj/machinery/door/firedoor,
/obj/effect/turf_decal/siding/wood{
	dir = 8
	},
/turf/open/floor/iron/dark/textured_large,
/area/ship/bridge)
"fr" = (
/obj/machinery/computer/helm{
	dir = 8
	},
/obj/effect/decal/cleanable/dirt/dust,
/turf/open/floor/carpet,
/area/ship/bridge)
"gD" = (
/obj/machinery/atmospherics/components/unary/vent_scrubber/on/layer2{
	dir = 1
	},
/obj/machinery/firealarm{
	dir = 8;
	pixel_x = -26
	},
/turf/open/floor/iron/grimy,
/area/ship/crew)
"gK" = (
/turf/closed/wall/mineral/titanium,
/area/ship/crew)
"gX" = (
/obj/structure/window/shuttle,
/obj/structure/grille,
/obj/machinery/door/poddoor/shutters{
	id = "pocketrocket_window";
	name = "Crew Quarters Exterior Window Shutters"
	},
/turf/open/floor/plating,
/area/ship/crew)
"hL" = (
/obj/machinery/airalarm/directional/west,
/obj/effect/decal/cleanable/dirt,
/obj/structure/table,
/obj/machinery/recharger{
	pixel_y = 4;
	pixel_x = 6
	},
/obj/item/stamp/captain{
	pixel_x = -7;
	pixel_y = 1
	},
/obj/item/pen/fountain/captain{
	pixel_y = 8;
	pixel_x = -5
	},
/turf/open/floor/wood,
/area/ship/bridge)
"hS" = (
/turf/closed/wall/mineral/titanium/nodiagonal,
/area/ship/crew/canteen)
"ib" = (
/obj/structure/cable{
	icon_state = "4-8"
	},
/obj/machinery/atmospherics/pipe/simple/supply/hidden/layer4{
	dir = 8
	},
/obj/machinery/atmospherics/pipe/simple/scrubbers/hidden/layer2{
	dir = 4
	},
/obj/effect/decal/cleanable/dirt,
/turf/open/floor/iron,
/area/ship/cargo)
"ij" = (
/obj/machinery/light/small{
	dir = 1
	},
/obj/machinery/atmospherics/components/unary/vent_pump/on/layer4{
	dir = 8
	},
/obj/machinery/airalarm/directional/north,
/obj/item/radio,
/obj/item/radio,
/obj/item/radio,
/obj/item/radio,
/obj/item/radio,
/obj/item/clothing/mask/breath,
/obj/item/clothing/mask/breath,
/obj/item/clothing/mask/breath,
/obj/item/clothing/mask/breath,
/obj/item/clothing/mask/breath,
/obj/item/tank/internals/emergency_oxygen,
/obj/item/tank/internals/emergency_oxygen,
/obj/item/tank/internals/emergency_oxygen,
/obj/item/tank/internals/emergency_oxygen,
/obj/item/tank/internals/emergency_oxygen,
/obj/effect/decal/cleanable/dirt,
/obj/item/crowbar,
/obj/item/crowbar,
/obj/item/crowbar,
/obj/item/crowbar,
/obj/item/crowbar,
/obj/effect/decal/cleanable/cobweb/cobweb2,
/obj/structure/closet/cabinet,
/turf/open/floor/iron/grimy,
/area/ship/crew)
"iL" = (
/obj/machinery/power/terminal{
	dir = 8
	},
/obj/machinery/light/small{
	dir = 4
	},
/obj/machinery/power/port_gen/pacman,
/obj/item/stack/sheet/mineral/plasma/five,
/obj/effect/turf_decal/industrial/warning,
/obj/effect/decal/cleanable/cobweb/cobweb2,
/turf/open/floor/iron/dark/small,
/area/ship/engineering)
"jp" = (
/obj/structure/window/shuttle,
/obj/machinery/door/poddoor/shutters{
	id = "pocketrocket_bridge_window";
	name = "Bridge Exterior Window Shutters"
	},
/obj/structure/grille,
/turf/open/floor/plating,
/area/ship/bridge)
"ko" = (
/obj/structure/cable{
	icon_state = "1-8"
	},
/obj/structure/cable{
	icon_state = "1-4"
	},
/obj/machinery/atmospherics/pipe/simple/supply/hidden/layer4{
	dir = 5
	},
/obj/machinery/atmospherics/pipe/manifold/scrubbers/hidden/layer2{
	dir = 8
	},
/turf/open/floor/iron,
/area/ship/engineering)
"lC" = (
/turf/closed/wall/mineral/titanium,
/area/ship/bridge)
"lE" = (
/obj/machinery/light{
	dir = 8
	},
/obj/machinery/atmospherics/components/unary/vent_pump/on/layer4{
	dir = 4
	},
/obj/effect/turf_decal/siding/wood{
	dir = 4
	},
/turf/open/floor/wood,
/area/ship/crew/canteen)
"md" = (
/obj/structure/cable{
	icon_state = "0-4"
	},
/obj/machinery/power/apc/auto_name/north,
/obj/effect/decal/cleanable/garbage,
/obj/structure/closet/emcloset/wall{
	dir = 4;
	pixel_x = -32
	},
/obj/effect/turf_decal/siding/wood/corner,
/obj/effect/decal/cleanable/cobweb,
/turf/open/floor/wood,
/area/ship/crew/canteen)
"mP" = (
/obj/structure/frame/computer{
	dir = 8
	},
/obj/item/shard,
/obj/effect/decal/cleanable/glass,
/turf/open/floor/carpet,
/area/ship/bridge)
"nc" = (
/obj/machinery/door/poddoor{
	id = "rocketpocket_cargo";
	name = "Cargo Bay Blast Door"
	},
/obj/structure/fans/tiny,
/obj/effect/turf_decal/industrial/warning,
/obj/effect/turf_decal/industrial/warning{
	dir = 1
	},
/turf/open/floor/iron/dark/textured_large,
/area/ship/cargo)
"nu" = (
/obj/machinery/atmospherics/components/unary/vent_scrubber/on/layer2,
/obj/effect/decal/cleanable/dirt,
/obj/structure/closet/secure_closet/captains{
	name = "pilot's locker";
	populate = 0
	},
/obj/item/clothing/under/rank/command/captain,
/obj/item/clothing/under/rank/command/captain/skirt,
/obj/item/clothing/suit/hooded/wintercoat/captain/neu,
/obj/item/clothing/head/collectable/captain,
/obj/item/clothing/head/beret/captain,
/obj/item/clothing/accessory/medal/gold/captain,
/obj/item/clothing/head/caphat/cowboy,
/obj/item/clothing/suit/armor/vest/capcarapace,
/obj/item/clothing/suit/armor/vest/capcarapace/alt,
/obj/effect/turf_decal/siding/wood{
	dir = 4
	},
/turf/open/floor/wood,
/area/ship/bridge)
"oB" = (
/obj/structure/cable{
	icon_state = "1-8"
	},
/obj/effect/decal/cleanable/dirt,
/obj/machinery/atmospherics/pipe/simple/scrubbers/hidden/layer2{
	dir = 4
	},
/obj/machinery/atmospherics/pipe/manifold/supply/hidden/layer4,
/turf/open/floor/iron,
/area/ship/cargo)
"oP" = (
/obj/machinery/atmospherics/pipe/simple/supply/hidden/layer4{
	dir = 8
	},
/obj/machinery/atmospherics/pipe/simple/scrubbers/hidden/layer2{
	dir = 9
	},
/obj/structure/cable{
	icon_state = "2-8"
	},
/obj/effect/turf_decal/siding/wood{
	dir = 4
	},
/turf/open/floor/wood,
/area/ship/bridge)
"oR" = (
/obj/machinery/power/shuttle/engine/electric{
	dir = 4
	},
/obj/structure/cable{
	icon_state = "0-4"
	},
/turf/open/floor/plating/airless,
/area/ship/engineering)
"pG" = (
/obj/machinery/computer/cryopod{
	dir = 1;
	pixel_y = -26
	},
/obj/machinery/cryopod{
	dir = 4
	},
/obj/effect/turf_decal/siding/thinplating/dark{
	dir = 5
	},
/turf/open/floor/iron/dark/small,
/area/ship/crew)
"rg" = (
/obj/machinery/atmospherics/components/unary/passive_vent/layer2{
	dir = 4
	},
/turf/open/floor/plating,
/area/ship/engineering)
"se" = (
/obj/structure/cable{
	icon_state = "4-8"
	},
/obj/structure/cable{
	icon_state = "1-8"
	},
/obj/machinery/atmospherics/pipe/manifold/supply/hidden/layer4{
	dir = 8
	},
/obj/machinery/atmospherics/pipe/manifold/scrubbers/hidden/layer2{
	dir = 8
	},
/obj/effect/decal/cleanable/dirt,
/obj/effect/decal/cleanable/dirt,
/turf/open/floor/iron,
/area/ship/cargo)
"tc" = (
/obj/machinery/airalarm/directional/north,
/obj/effect/decal/cleanable/sprayweb,
/obj/effect/turf_decal/siding/wood/corner{
	dir = 8
	},
/turf/open/floor/wood,
/area/ship/crew/canteen)
"tw" = (
/obj/machinery/power/smes/shuttle/precharged{
	dir = 4
	},
/obj/structure/window/reinforced{
	dir = 8
	},
/obj/machinery/door/window/eastright{
	name = "Engineering Engine Access"
	},
/obj/structure/cable{
	icon_state = "0-8"
	},
/obj/machinery/door/poddoor/shutters{
	id = "pocketrocket_engine";
	name = "Engineering Engine Shutters"
	},
/turf/open/floor/plating,
/area/ship/engineering)
"uS" = (
/obj/structure/table/wood,
/obj/machinery/cell_charger,
/obj/structure/extinguisher_cabinet{
	pixel_x = 26
	},
/obj/item/reagent_containers/glass/rag,
/obj/effect/decal/cleanable/dirt/dust,
/obj/effect/turf_decal/siding/wood/corner{
	dir = 1
	},
/turf/open/floor/wood,
/area/ship/crew/canteen)
"vo" = (
/obj/machinery/power/apc/auto_name/south,
/obj/machinery/light,
/obj/structure/cable,
/obj/effect/decal/cleanable/dirt,
/obj/structure/table,
/obj/effect/turf_decal/siding/wood{
	dir = 4
	},
/obj/item/paper_bin{
	pixel_y = 5
	},
/turf/open/floor/wood,
/area/ship/bridge)
"wv" = (
/obj/machinery/atmospherics/components/unary/vent_pump/on/layer4{
	dir = 8
	},
/obj/structure/chair/comfy/shuttle{
	desc = "STOP! YOU'RE GOING TO TEST THIS SHIP RIGHT INTO AN ICEBERG!";
	dir = 4;
	name = "Helmsman";
	layer = 2.49
	},
/obj/effect/decal/cleanable/dirt/dust,
/turf/open/floor/carpet,
/area/ship/bridge)
"wH" = (
/turf/closed/wall/mineral/titanium/nodiagonal,
/area/ship/cargo)
"xf" = (
/obj/structure/closet/crate/engineering,
/obj/item/storage/box/rndboards,
/obj/item/stack/sheet/metal/fifty,
/obj/item/stack/sheet/glass/fifty,
/obj/item/circuitboard/machine/autolathe,
/obj/item/circuitboard/machine/ore_silo,
/obj/item/circuitboard/machine/ore_redemption,
/obj/item/storage/box/stockparts/basic,
/obj/item/storage/box/stockparts/basic,
/obj/item/storage/toolbox/mechanical,
/obj/item/storage/toolbox/electrical,
/obj/item/areaeditor/shuttle,
/obj/effect/turf_decal/siding/thinplating/dark,
/obj/effect/decal/cleanable/cobweb,
/turf/open/floor/iron/dark/small,
/area/ship/cargo)
"xr" = (
/obj/machinery/atmospherics/components/binary/pump/on/layer4,
/obj/effect/decal/cleanable/dirt,
/obj/machinery/power/terminal{
	dir = 8
	},
/obj/structure/cable{
	icon_state = "0-4"
	},
/obj/effect/turf_decal/siding/thinplating/dark{
	dir = 1
	},
/turf/open/floor/iron,
/area/ship/engineering)
"xA" = (
/obj/machinery/power/smes/shuttle/precharged{
	dir = 4
	},
/obj/structure/cable{
	icon_state = "0-8"
	},
/obj/structure/window/reinforced{
	dir = 8
	},
/obj/machinery/door/window/eastright{
	name = "Engineering Engine Access"
	},
/obj/machinery/door/poddoor/shutters{
	id = "pocketrocket_engine";
	name = "Engineering Engine Shutters"
	},
/turf/open/floor/plating,
/area/ship/engineering)
"xI" = (
/turf/template_noop,
/area/template_noop)
"yI" = (
/obj/structure/cable{
	icon_state = "1-2"
	},
/obj/structure/cable{
	icon_state = "2-4"
	},
/obj/machinery/atmospherics/pipe/manifold/supply/hidden/layer4{
	dir = 1
	},
/obj/machinery/atmospherics/pipe/simple/scrubbers/hidden/layer2{
	dir = 6
	},
/obj/effect/decal/cleanable/dirt,
/obj/effect/decal/cleanable/dirt/dust,
/turf/open/floor/carpet/green,
/area/ship/crew/canteen)
"zn" = (
/obj/effect/decal/cleanable/dirt,
/obj/structure/cable{
	icon_state = "1-2"
	},
/obj/machinery/atmospherics/pipe/simple/supply/hidden/layer4,
/obj/machinery/atmospherics/pipe/simple/scrubbers/hidden/layer2{
	dir = 10
	},
/obj/machinery/button/door{
	id = "rocketpocket_cargo";
	name = "Engineering Engine Access Shutters Control";
	pixel_x = 26
	},
/obj/machinery/light/small{
	dir = 4
	},
/turf/open/floor/plating,
/area/ship/engineering)
"BC" = (
/obj/structure/cable{
	icon_state = "1-2"
	},
/obj/machinery/atmospherics/pipe/simple/supply/hidden/layer4,
/obj/machinery/atmospherics/pipe/simple/scrubbers/hidden/layer2,
/obj/effect/turf_decal/siding/wood{
	dir = 1
	},
/turf/open/floor/wood,
/area/ship/crew/canteen)
"BZ" = (
/turf/closed/wall/mineral/titanium/nodiagonal,
/area/ship/crew)
"CB" = (
/obj/structure/cable{
	icon_state = "4-8"
	},
/obj/machinery/door/airlock/public/glass{
	name = "Crew Quarters"
	},
/obj/machinery/atmospherics/pipe/simple/supply/hidden/layer4{
	dir = 8
	},
/obj/machinery/atmospherics/pipe/simple/scrubbers/hidden/layer2{
	dir = 4
	},
/obj/machinery/door/firedoor,
/obj/effect/decal/cleanable/dirt,
/turf/open/floor/iron/dark/textured_large,
/area/ship/crew)
"Df" = (
/obj/structure/cable{
	icon_state = "4-8"
	},
/obj/machinery/atmospherics/pipe/simple/supply/hidden/layer4{
	dir = 8
	},
/obj/machinery/atmospherics/pipe/simple/scrubbers/hidden/layer2{
	dir = 4
	},
/obj/effect/decal/cleanable/dirt,
/turf/open/floor/wood,
/area/ship/bridge)
"Dx" = (
/obj/machinery/light,
/obj/structure/closet/crate/secure/weapon,
/obj/item/gun/ballistic/automatic/pistol/disposable,
/obj/item/gun/ballistic/automatic/pistol/disposable,
/obj/item/gun/ballistic/automatic/pistol/disposable,
/obj/item/gun/ballistic/automatic/pistol/disposable,
/obj/item/gun/ballistic/automatic/pistol/disposable,
/obj/item/gun/energy/laser,
/obj/effect/turf_decal/siding/thinplating/dark{
	dir = 8
	},
/turf/open/floor/iron/dark/small,
/area/ship/cargo)
"DK" = (
/obj/machinery/power/shuttle/engine/electric{
	dir = 4
	},
/obj/structure/cable{
	icon_state = "0-4"
	},
/turf/open/floor/plating,
/area/ship/engineering)
"Ec" = (
/obj/structure/cable{
	icon_state = "0-8"
	},
/obj/machinery/atmospherics/pipe/simple/supply/hidden/layer4{
	dir = 8
	},
/obj/machinery/power/apc/auto_name/north,
/obj/machinery/atmospherics/pipe/simple/scrubbers/hidden/layer2{
	dir = 10
	},
/obj/effect/decal/cleanable/dirt,
/obj/effect/decal/cleanable/dirt,
/turf/open/floor/iron/grimy,
/area/ship/crew)
"Fe" = (
/obj/machinery/computer/autopilot{
	dir = 8
	},
/obj/effect/decal/cleanable/cobweb/cobweb2,
/turf/open/floor/carpet,
/area/ship/bridge)
"Ft" = (
/obj/machinery/power/smes,
/obj/structure/cable{
	icon_state = "0-2"
	},
/obj/effect/turf_decal/industrial/warning,
/obj/machinery/airalarm/directional/north,
/turf/open/floor/iron/dark/small,
/area/ship/engineering)
"FZ" = (
/obj/machinery/atmospherics/components/unary/vent_scrubber/on/layer2{
	dir = 1
	},
/turf/open/floor/iron,
/area/ship/cargo)
"Hx" = (
/obj/effect/decal/cleanable/greenglow,
/obj/effect/decal/cleanable/dirt,
/obj/structure/cable{
	icon_state = "1-8"
	},
/obj/structure/cable{
	icon_state = "1-2"
	},
/obj/machinery/atmospherics/pipe/manifold/supply/hidden/layer4{
	dir = 4
	},
/turf/open/floor/iron,
/area/ship/engineering)
"HE" = (
/obj/machinery/atmospherics/components/unary/vent_scrubber/on/layer2{
	dir = 1
	},
/obj/effect/turf_decal/industrial/hatch/yellow,
/obj/machinery/suit_storage_unit/independent/engineering,
/obj/effect/decal/cleanable/dirt,
/obj/effect/turf_decal/siding/thinplating/dark{
	dir = 1
	},
/turf/open/floor/iron/dark/small,
/area/ship/engineering)
"HV" = (
/obj/machinery/button/door{
	id = "rocketpocket_cargo";
	name = "Cargo Bay Blast Doors Control";
	pixel_x = 26
	},
/obj/effect/turf_decal/siding/thinplating/dark{
	dir = 9
	},
/turf/open/floor/iron/dark/small,
/area/ship/cargo)
"Ib" = (
/obj/machinery/door/airlock{
	name = "Crew Quarters Toilet"
	},
/turf/open/floor/iron/dark/textured_large,
/area/ship/crew)
"Iq" = (
/obj/machinery/power/smes/shuttle/precharged{
	dir = 4
	},
/obj/structure/window/reinforced{
	dir = 8
	},
/obj/machinery/door/window/eastleft{
	name = "Engineering Engine Access"
	},
/obj/structure/cable{
	icon_state = "0-8"
	},
/obj/machinery/door/poddoor/shutters{
	id = "pocketrocket_engine";
	name = "Engineering Engine Shutters"
	},
/turf/open/floor/plating,
/area/ship/engineering)
"Ix" = (
/obj/structure/closet/crate,
/obj/item/storage/backpack/duffelbag/mining_conscript,
/obj/item/clothing/glasses/meson,
/obj/effect/spawner/lootdrop/maintenance/four,
/obj/item/storage/belt/fannypack,
/obj/item/storage/firstaid/advanced,
/obj/machinery/firealarm{
	dir = 8;
	pixel_x = -26
	},
/obj/effect/turf_decal/siding/thinplating/dark{
	dir = 5
	},
/turf/open/floor/iron/dark/small,
/area/ship/cargo)
"IE" = (
/obj/structure/cable{
	icon_state = "2-4"
	},
/obj/structure/cable{
	icon_state = "0-4"
	},
/obj/machinery/light{
	dir = 1
	},
/obj/machinery/power/apc/auto_name/north,
/obj/machinery/atmospherics/components/unary/vent_pump/on/layer4,
/obj/effect/turf_decal/siding/thinplating/dark{
	dir = 6
	},
/turf/open/floor/iron/dark/small,
/area/ship/cargo)
"Jk" = (
/obj/machinery/atmospherics/components/unary/tank/air{
	piping_layer = 4;
	pixel_x = 4
	},
/obj/effect/decal/cleanable/dirt,
/obj/effect/turf_decal/industrial/warning,
/obj/machinery/light/small{
	dir = 8
	},
/turf/open/floor/iron/dark/small,
/area/ship/engineering)
"Jq" = (
/obj/machinery/firealarm{
	pixel_y = -24
	},
/obj/effect/decal/cleanable/dirt,
/obj/structure/table,
/obj/item/storage/toolbox/emergency,
/obj/item/flashlight,
/turf/open/floor/wood,
/area/ship/bridge)
"JK" = (
/obj/machinery/firealarm{
	dir = 8;
	pixel_x = -26
	},
/obj/machinery/atmospherics/pipe/simple/scrubbers/hidden/layer2{
	dir = 4
	},
/obj/item/clothing/suit/toggle/industrial,
/turf/open/floor/iron,
/area/ship/engineering)
"JW" = (
/turf/closed/wall/mineral/titanium/nodiagonal,
/area/ship/bridge)
"Kh" = (
/obj/structure/cable{
	icon_state = "0-4"
	},
/obj/machinery/power/terminal{
	dir = 8
	},
/obj/effect/decal/cleanable/dirt,
/turf/open/floor/iron,
/area/ship/engineering)
"KI" = (
/obj/structure/window/shuttle,
/obj/structure/grille,
/obj/machinery/door/poddoor/shutters{
	id = "pocketrocket_window";
	name = "Canteen Exterior Window Shutters"
	},
/turf/open/floor/plating,
/area/ship/crew/canteen)
"KO" = (
/obj/machinery/suit_storage_unit/independent/pilot,
/obj/effect/turf_decal/siding/wood{
	dir = 1
	},
/turf/open/floor/wood,
/area/ship/bridge)
"Lg" = (
/obj/machinery/door/airlock/hatch{
	name = "Engineering"
	},
/obj/structure/cable{
	icon_state = "4-8"
	},
/obj/machinery/atmospherics/pipe/simple/supply/hidden/layer4{
	dir = 8
	},
/obj/machinery/atmospherics/pipe/simple/scrubbers/hidden/layer2{
	dir = 4
	},
/obj/machinery/door/firedoor,
/turf/open/floor/iron/dark/textured_large,
/area/ship/engineering)
"MC" = (
/obj/structure/cable{
	icon_state = "4-8"
	},
/obj/machinery/atmospherics/pipe/simple/supply/hidden/layer4{
	dir = 8
	},
/obj/machinery/atmospherics/pipe/manifold/scrubbers/hidden/layer2{
	dir = 2
	},
/obj/effect/decal/cleanable/vomit,
/obj/effect/decal/cleanable/dirt/dust,
/turf/open/floor/carpet/green,
/area/ship/crew/canteen)
"ND" = (
/obj/effect/turf_decal/industrial/hatch/yellow,
/obj/machinery/suit_storage_unit/independent/engineering,
/obj/effect/decal/cleanable/dirt,
/obj/effect/turf_decal/siding/thinplating/dark{
	dir = 1
	},
/obj/machinery/light/small{
	dir = 8
	},
/turf/open/floor/iron/dark/small,
/area/ship/engineering)
"NK" = (
/obj/structure/table/wood,
/obj/item/chair/plastic{
	pixel_y = 6
	},
/obj/item/chair/plastic,
/obj/item/storage/fancy/candle_box,
/obj/effect/decal/cleanable/dirt/dust,
/obj/effect/turf_decal/siding/wood/corner{
	dir = 4
	},
/turf/open/floor/wood,
/area/ship/crew/canteen)
"Qd" = (
/turf/closed/wall/mineral/titanium,
/area/ship/engineering)
"QL" = (
/obj/effect/decal/cleanable/glass,
/turf/open/floor/carpet,
/area/ship/bridge)
"Re" = (
/obj/machinery/power/smes/shuttle/precharged{
	dir = 4
	},
/obj/structure/window/reinforced{
	dir = 8
	},
/obj/structure/cable{
	icon_state = "0-8"
	},
/obj/machinery/door/window/eastleft{
	name = "Engineering Engine Access"
	},
/obj/machinery/door/poddoor/shutters{
	id = "pocketrocket_engine";
	name = "Engineering Engine Shutters"
	},
/turf/open/floor/plating,
/area/ship/engineering)
"Rr" = (
/obj/machinery/atmospherics/pipe/simple/supply/hidden/layer4{
	dir = 8
	},
/obj/machinery/atmospherics/pipe/simple/scrubbers/hidden/layer2{
	dir = 4
	},
/obj/structure/cable{
	icon_state = "4-8"
	},
/obj/machinery/airalarm/directional/north,
/turf/open/floor/iron,
/area/ship/cargo)
"RO" = (
/obj/structure/sink{
	dir = 8;
	pixel_x = 13
	},
/obj/structure/mirror{
	pixel_x = 26
	},
/turf/open/floor/iron/showroomfloor,
/area/ship/crew)
"Sz" = (
/obj/structure/cable{
	icon_state = "4-8"
	},
/obj/machinery/atmospherics/pipe/simple/supply/hidden/layer4{
	dir = 8
	},
/obj/machinery/atmospherics/pipe/simple/scrubbers/hidden/layer2{
	dir = 4
	},
/obj/effect/turf_decal/siding/wood{
	dir = 8
	},
/turf/open/floor/wood,
/area/ship/crew/canteen)
"Tw" = (
/obj/machinery/power/apc/auto_name/east,
/obj/structure/reagent_dispensers/fueltank,
/turf/open/floor/iron,
/area/ship/engineering)
"UB" = (
/obj/structure/cable{
	icon_state = "2-8"
	},
/obj/item/reagent_containers/glass/rag,
/obj/effect/decal/cleanable/dirt/dust,
/obj/effect/turf_decal/siding/wood,
/turf/open/floor/wood,
/area/ship/crew/canteen)
"UH" = (
/obj/effect/decal/cleanable/dirt,
/obj/structure/dresser,
/turf/open/floor/iron/grimy,
/area/ship/crew)
"VF" = (
/obj/structure/cable{
	icon_state = "0-4"
	},
/obj/machinery/power/terminal{
	dir = 8
	},
/obj/effect/decal/cleanable/dirt,
/turf/open/floor/plating,
/area/ship/engineering)
"WL" = (
/obj/structure/cable{
	icon_state = "1-8"
	},
/obj/structure/cable{
	icon_state = "1-2"
	},
/obj/machinery/atmospherics/pipe/simple/supply/hidden/layer4,
/obj/machinery/atmospherics/pipe/simple/scrubbers/hidden/layer2{
	dir = 1
	},
/turf/open/floor/iron,
/area/ship/engineering)
"WY" = (
/obj/docking_port/mobile{
	launch_status = 0;
	port_direction = 2
	},
/obj/structure/fans/tiny,
/obj/machinery/door/poddoor{
	id = "rocketpocket_cargo";
	name = "Cargo Bay Blast Door"
	},
/obj/effect/turf_decal/industrial/warning,
/obj/effect/turf_decal/industrial/warning{
	dir = 1
	},
/turf/open/floor/iron/dark/textured_large,
/area/ship/cargo)
"Xa" = (
/obj/structure/toilet{
	dir = 8
	},
/obj/machinery/light/small{
	dir = 1
	},
/turf/open/floor/iron/showroomfloor,
/area/ship/crew)
"XD" = (
/obj/machinery/atmospherics/components/unary/vent_scrubber/on/layer2,
/obj/effect/turf_decal/siding/wood,
/turf/open/floor/wood,
/area/ship/crew/canteen)
"Zv" = (
/obj/machinery/power/terminal{
	dir = 8
	},
/obj/machinery/atmospherics/pipe/simple/supply/hidden/layer4{
	dir = 5
	},
/obj/effect/decal/cleanable/dirt,
/obj/structure/cable{
	icon_state = "0-4"
	},
/turf/open/floor/plating,
/area/ship/engineering)
"ZQ" = (
/obj/machinery/atmospherics/pipe/simple/supply/hidden/layer4{
	dir = 9
	},
/obj/effect/decal/cleanable/dirt,
/obj/machinery/atmospherics/pipe/manifold/scrubbers/hidden/layer2{
	dir = 4
	},
/turf/open/floor/iron,
/area/ship/cargo)

(1,1,1) = {"
xI
xI
bU
DK
oR
rg
DK
DK
bU
xI
"}
(2,1,1) = {"
xI
Qd
bU
Re
xA
cK
Iq
tw
bU
Qd
"}
(3,1,1) = {"
xI
bU
Jk
xr
Zv
JK
VF
Kh
ND
bU
"}
(4,1,1) = {"
xI
bU
Ft
da
Hx
zn
WL
ko
HE
bU
"}
(5,1,1) = {"
xI
bU
iL
eR
Tw
aj
bU
Lg
bU
bU
"}
(6,1,1) = {"
xI
bU
bU
bU
bU
bU
xf
ib
Ix
wH
"}
(7,1,1) = {"
xI
hS
md
lE
NK
hS
IE
oB
cV
WY
"}
(8,1,1) = {"
xI
KI
UB
yI
BC
cg
se
ZQ
FZ
nc
"}
(9,1,1) = {"
xI
KI
XD
MC
ad
hS
Rr
HV
Dx
wH
"}
(10,1,1) = {"
xI
hS
tc
Sz
uS
hS
CB
BZ
BZ
BZ
"}
(11,1,1) = {"
xI
JW
JW
fe
JW
BZ
Ec
gD
pG
BZ
"}
(12,1,1) = {"
xI
JW
hL
Df
Jq
BZ
ij
dZ
UH
gX
"}
(13,1,1) = {"
xI
JW
nu
oP
vo
BZ
BZ
Ib
BZ
BZ
"}
(14,1,1) = {"
xI
JW
aF
wv
QL
KO
BZ
Xa
RO
BZ
"}
(15,1,1) = {"
xI
JW
Fe
fr
mP
JW
BZ
BZ
BZ
gK
"}
(16,1,1) = {"
xI
lC
jp
jp
jp
lC
xI
xI
xI
xI
"}
