//MAP CONVERTED BY dmm2tgm.py THIS HEADER COMMENT PREVENTS RECONVERSION, DO NOT REMOVE
"a" = (
/turf/template_noop,
/area/ship/medical)
"f" = (
/turf/template_noop,
/area/ship/cargo/office)
"g" = (
/turf/template_noop,
/area/ship/crew/office)
"h" = (
/turf/template_noop,
/area/ship/bridge)
"k" = (
/turf/template_noop,
/area/ship/maintenance/fore)
"m" = (
/obj/structure/catwalk/over,
/obj/structure/marker_beacon,
/turf/open/floor/plating/airless,
/area/ship/external)
"C" = (
/turf/template_noop,
/area/template_noop)
"E" = (
/turf/template_noop,
/area/ship/maintenance/central)
"G" = (
/turf/template_noop,
/area/ship/medical/surgery)
"I" = (
/turf/template_noop,
/area/ship/hallway/starboard)
"R" = (
/turf/template_noop,
/area/ship/hallway/central)
"V" = (
/turf/template_noop,
/area/ship/cargo)
"Y" = (
/obj/structure/lattice,
/turf/template_noop,
/area/ship/external)
"Z" = (
/turf/template_noop,
/area/ship/science)

(1,1,1) = {"
C
C
C
C
C
C
C
C
C
C
C
C
C
C
C
C
C
C
C
C
C
C
C
C
C
C
C
C
C
C
C
C
C
C
"}
(2,1,1) = {"
C
C
C
C
C
C
C
C
C
C
C
C
C
C
C
C
C
C
C
C
C
C
C
C
C
C
C
C
C
C
C
C
C
C
"}
(3,1,1) = {"
C
C
C
C
C
C
C
C
C
C
C
C
C
C
C
C
C
C
C
C
C
C
C
C
C
C
C
C
C
C
C
C
C
C
"}
(4,1,1) = {"
C
C
C
C
C
C
C
C
C
C
C
C
C
C
C
C
C
C
C
C
C
C
C
C
C
C
C
C
C
C
C
C
C
C
"}
(5,1,1) = {"
C
C
C
C
C
C
C
C
C
C
C
C
C
C
C
C
C
C
C
C
C
C
C
C
C
C
C
C
C
C
C
C
C
C
"}
(6,1,1) = {"
C
C
C
C
C
C
C
C
C
C
C
C
C
C
C
C
C
C
C
C
C
C
C
C
C
C
C
C
C
C
C
C
C
C
"}
(7,1,1) = {"
C
C
C
C
C
C
C
C
C
C
C
C
C
C
C
C
C
C
C
C
C
C
C
C
C
C
C
C
C
C
C
C
C
C
"}
(8,1,1) = {"
C
C
C
C
C
C
C
C
C
C
C
C
C
C
C
C
C
C
C
C
C
C
C
C
C
C
C
C
C
C
C
C
C
C
"}
(9,1,1) = {"
C
C
C
C
C
C
C
C
C
C
C
C
C
R
R
R
R
R
C
C
C
C
C
C
C
C
C
C
C
C
C
C
C
C
"}
(10,1,1) = {"
C
C
C
C
C
C
C
C
C
C
C
C
C
R
R
R
R
R
C
C
C
C
C
C
C
C
C
C
C
C
C
C
C
C
"}
(11,1,1) = {"
C
C
C
C
C
C
C
C
C
C
C
C
C
R
R
R
R
R
C
C
C
C
C
C
C
C
C
C
C
C
C
C
C
C
"}
(12,1,1) = {"
C
C
C
C
C
C
C
C
C
C
C
C
C
R
R
R
R
R
C
C
C
C
C
C
C
C
C
C
C
C
C
C
C
C
"}
(13,1,1) = {"
C
C
C
C
C
C
C
C
C
C
C
C
C
R
R
R
R
R
C
C
C
C
C
C
C
C
C
C
C
C
C
C
C
C
"}
(14,1,1) = {"
C
C
C
C
C
C
C
C
C
C
C
C
C
R
R
R
R
R
C
C
C
C
C
C
C
C
C
C
C
C
C
C
C
C
"}
(15,1,1) = {"
C
C
C
C
C
C
C
C
C
C
C
C
C
R
R
R
R
R
C
C
C
C
C
C
C
C
C
C
C
C
C
C
C
C
"}
(16,1,1) = {"
C
C
C
C
C
C
C
C
C
C
C
C
C
R
R
R
R
R
I
I
I
I
I
I
I
I
I
I
C
C
C
C
C
C
"}
(17,1,1) = {"
C
C
C
C
C
C
C
C
C
C
C
C
C
R
R
R
R
R
I
I
I
I
I
I
I
I
I
I
I
C
C
C
C
C
"}
(18,1,1) = {"
C
C
C
C
C
C
C
C
C
C
C
C
C
R
R
R
R
R
I
I
I
I
I
I
I
I
I
I
I
C
C
C
C
C
"}
(19,1,1) = {"
C
C
C
C
C
C
C
C
C
C
C
C
C
R
R
R
R
R
I
I
I
I
I
I
I
I
I
I
I
C
C
C
C
C
"}
(20,1,1) = {"
C
C
C
C
C
C
C
C
C
C
C
C
C
R
R
R
R
R
I
I
I
I
I
I
I
I
I
I
I
C
C
C
C
C
"}
(21,1,1) = {"
C
C
C
C
C
C
C
C
C
C
C
C
C
R
R
R
R
R
Z
Z
Z
Z
Z
Z
I
I
I
I
I
C
C
C
C
C
"}
(22,1,1) = {"
C
C
C
C
C
C
C
C
C
C
C
C
C
R
R
R
R
R
Z
Z
Z
Z
Z
Z
I
I
I
I
I
C
C
C
C
C
"}
(23,1,1) = {"
C
C
C
C
C
C
C
C
C
C
C
C
C
R
R
R
R
R
Z
Z
Z
Z
Z
Z
I
I
I
I
I
g
g
g
g
g
"}
(24,1,1) = {"
C
C
C
C
C
C
C
C
C
C
C
C
C
R
R
R
R
R
Z
Z
Z
Z
Z
Z
I
I
I
I
I
g
g
g
g
g
"}
(25,1,1) = {"
C
C
C
C
C
C
C
C
C
C
C
C
C
R
R
R
R
R
Z
Z
Z
Z
Z
Z
I
I
I
I
I
g
g
g
g
g
"}
(26,1,1) = {"
C
C
C
C
C
C
C
C
C
C
C
C
C
R
R
R
R
R
Z
Z
Z
Z
Z
Z
I
I
I
I
I
g
g
g
g
g
"}
(27,1,1) = {"
C
C
C
C
C
C
C
C
C
C
C
C
C
R
R
R
R
R
a
a
a
a
a
a
I
I
I
I
I
g
g
g
g
g
"}
(28,1,1) = {"
C
C
C
C
C
C
C
C
C
C
C
C
C
R
R
R
R
R
a
a
a
a
a
a
G
G
G
G
h
g
g
g
g
g
"}
(29,1,1) = {"
C
C
C
C
C
C
C
E
E
E
E
E
E
R
R
R
R
R
a
a
a
a
a
a
G
G
G
G
h
h
h
h
h
h
"}
(30,1,1) = {"
C
C
C
C
C
C
C
E
E
E
E
E
E
R
R
R
R
R
a
a
a
a
a
a
G
G
G
G
h
h
h
h
h
h
"}
(31,1,1) = {"
C
C
C
C
C
C
C
E
E
E
E
E
E
R
R
R
R
R
a
a
a
a
a
a
G
G
G
G
h
h
h
h
h
h
"}
(32,1,1) = {"
C
C
C
C
C
C
C
E
E
E
E
E
E
R
R
R
R
R
a
a
a
a
a
a
G
G
G
G
h
h
h
h
h
h
"}
(33,1,1) = {"
C
C
C
C
C
C
C
E
E
E
E
E
E
R
R
R
R
R
a
a
a
a
a
a
f
f
f
f
h
h
h
h
h
h
"}
(34,1,1) = {"
C
C
C
C
C
C
C
E
E
E
E
E
E
R
R
R
R
R
a
a
a
a
a
a
f
f
f
f
h
h
h
h
h
h
"}
(35,1,1) = {"
C
C
C
C
C
C
C
E
E
E
E
E
E
R
R
R
R
R
a
a
a
a
a
a
f
f
f
f
h
h
h
h
h
h
"}
(36,1,1) = {"
C
C
C
C
C
C
C
k
k
k
k
k
k
k
k
k
k
k
a
a
a
a
a
a
f
f
f
f
h
h
h
h
h
h
"}
(37,1,1) = {"
C
C
C
C
C
C
C
k
k
k
k
k
k
k
k
k
k
k
a
a
a
a
a
a
f
f
f
f
h
h
h
h
h
C
"}
(38,1,1) = {"
C
C
C
C
C
C
C
k
k
k
k
k
k
k
k
k
k
k
V
V
V
V
V
V
V
V
V
V
h
h
h
h
C
C
"}
(39,1,1) = {"
C
C
C
C
C
C
C
k
k
k
k
k
k
k
k
k
k
k
V
V
V
V
V
V
V
V
V
V
V
V
C
C
C
C
"}
(40,1,1) = {"
C
C
C
C
C
C
C
k
k
k
k
k
k
k
k
k
k
k
V
V
V
V
V
V
V
V
V
V
V
C
C
C
C
C
"}
(41,1,1) = {"
C
C
C
C
C
C
C
k
k
k
k
k
k
k
k
k
k
k
V
V
V
V
V
V
V
V
V
V
C
C
C
C
C
C
"}
(42,1,1) = {"
C
C
C
C
C
C
C
k
k
k
k
k
k
k
k
k
k
k
V
V
V
V
V
V
V
V
V
C
C
C
C
C
C
C
"}
(43,1,1) = {"
C
C
C
C
C
C
C
k
k
k
k
k
k
k
k
k
k
k
V
V
V
V
V
V
V
V
C
C
C
C
C
C
C
C
"}
(44,1,1) = {"
C
C
C
C
C
C
C
k
k
k
k
k
k
k
k
k
k
k
V
V
V
V
V
V
V
C
C
C
C
C
C
C
C
C
"}
(45,1,1) = {"
C
C
C
C
C
C
C
k
k
k
k
k
k
k
k
k
k
k
V
V
V
V
V
V
C
C
C
C
C
C
C
C
C
C
"}
(46,1,1) = {"
C
C
C
C
C
C
C
k
k
k
k
k
k
k
k
k
k
k
V
V
V
V
V
V
C
C
C
C
C
C
C
C
C
C
"}
(47,1,1) = {"
C
C
C
C
C
C
C
k
k
k
k
k
k
k
k
k
k
k
V
V
V
V
V
V
C
C
C
C
C
C
C
C
C
C
"}
(48,1,1) = {"
C
C
C
C
C
C
C
k
k
k
k
k
k
k
k
k
k
k
V
V
V
V
V
V
C
C
C
C
C
C
C
C
C
C
"}
(49,1,1) = {"
C
C
C
C
C
C
C
k
k
k
k
k
k
k
k
k
k
k
V
V
V
V
V
V
C
C
C
C
C
C
C
C
C
C
"}
(50,1,1) = {"
C
C
C
C
C
C
C
k
k
k
k
k
k
k
k
k
k
k
V
V
V
V
V
C
C
C
C
C
C
C
C
C
C
C
"}
(51,1,1) = {"
C
C
C
C
C
C
C
k
k
k
k
k
k
k
k
k
k
k
V
V
V
V
C
C
C
C
C
C
C
C
C
C
C
C
"}
(52,1,1) = {"
C
C
C
C
C
C
C
C
k
k
k
k
k
k
k
k
k
C
C
Y
C
C
C
C
C
C
C
C
C
C
C
C
C
C
"}
(53,1,1) = {"
C
C
C
C
C
C
C
C
k
k
k
k
k
k
k
k
k
C
C
m
C
C
C
C
C
C
C
C
C
C
C
C
C
C
"}
