//MAP CONVERTED BY dmm2tgm.py THIS HEADER COMMENT PREVENTS RECONVERSION, DO NOT REMOVE
"a" = (
/turf/open/floor/plating,
/area/ship/bridge)
"c" = (
/obj/machinery/power/terminal{
	dir = 8
	},
/obj/structure/cable{
	icon_state = "0-8"
	},
/obj/machinery/power/port_gen/pacman,
/turf/open/floor/plating,
/area/ship/bridge)
"d" = (
/obj/structure/holosign/barrier/engineering,
/turf/open/floor/plating,
/area/ship/bridge)
"e" = (
/obj/effect/decal/cleanable/blood/gibs,
/obj/effect/mob_spawn/human/corpse/nanotrasensoldier,
/turf/open/floor/plating,
/area/ship/bridge)
"i" = (
/obj/machinery/power/terminal{
	dir = 8
	},
/obj/structure/cable{
	icon_state = "0-2"
	},
/turf/closed/wall/mineral/plastitanium,
/area/ship/bridge)
"j" = (
/obj/machinery/power/shuttle/engine/electric{
	dir = 4
	},
/obj/structure/cable{
	icon_state = "0-4"
	},
/turf/open/floor/plating/airless,
/area/ship/bridge)
"k" = (
/obj/structure/sign/poster/official/moth/supermatter,
/turf/closed/wall/mineral/plastitanium,
/area/ship/bridge)
"p" = (
/obj/machinery/power/smes/shuttle/precharged{
	dir = 8
	},
/obj/structure/cable{
	icon_state = "0-8"
	},
/turf/closed/wall/mineral/plastitanium,
/area/ship/bridge)
"q" = (
/obj/machinery/light/broken{
	dir = 1
	},
/obj/structure/sign/poster/official/no_erp{
	pixel_y = 32
	},
/turf/open/floor/plating,
/area/ship/bridge)
"r" = (
/obj/structure/window/plasma/reinforced{
	dir = 4
	},
/turf/open/floor/plating,
/area/ship/bridge)
"v" = (
/obj/effect/decal/cleanable/dirt/dust,
/obj/effect/decal/cleanable/dirt/dust,
/obj/structure/holosign/barrier/engineering,
/turf/open/floor/plating,
/area/ship/bridge)
"y" = (
/obj/effect/decal/cleanable/blood/gibs/body,
/obj/structure/holosign/barrier/engineering,
/turf/open/floor/plating,
/area/ship/bridge)
"z" = (
/turf/closed/wall/mineral/plastitanium,
/area/ship/bridge)
"A" = (
/obj/machinery/light{
	dir = 1
	},
/obj/structure/cable{
	icon_state = "1-2"
	},
/obj/machinery/computer/helm,
/obj/machinery/vending/security/marine{
	all_items_free = 1;
	pixel_y = 32
	},
/turf/open/floor/plating,
/area/ship/bridge)
"C" = (
/obj/effect/decal/cleanable/blood,
/obj/structure/holosign/barrier/engineering,
/turf/open/floor/plating,
/area/ship/bridge)
"D" = (
/obj/effect/decal/cleanable/robot_debris,
/turf/open/floor/plating,
/area/ship/bridge)
"E" = (
/obj/structure/frame/machine,
/turf/open/floor/plating,
/area/ship/bridge)
"F" = (
/obj/structure/fans/tiny,
/obj/docking_port/mobile{
	callTime = 50;
	dir = 4;
	dwidth = 4;
	height = 5;
	ignitionTime = 25;
	launch_status = 0;
	name = "Syndicate Fighter";
	port_direction = 2;
	preferred_direction = 4;
	width = 9
	},
/obj/machinery/door/airlock/hatch,
/turf/open/floor/plating,
/area/ship/bridge)
"G" = (
/turf/template_noop,
/area/template_noop)
"I" = (
/obj/structure/closet/crate/large,
/obj/item/stack/sheet/metal/fifty,
/obj/item/stack/sheet/glass/fifty,
/obj/item/stack/sheet/mineral/plastitanium{
	amount = 20
	},
/obj/item/stack/sheet/plastitaniumglass{
	amount = 20
	},
/obj/item/stack/sheet/mineral/plasma/five,
/obj/item/areaeditor/shuttle,
/obj/item/storage/toolbox/syndicate,
/obj/item/pickaxe,
/obj/item/pickaxe,
/obj/item/pickaxe,
/obj/effect/decal/cleanable/cobweb,
/turf/open/floor/plating,
/area/ship/bridge)
"J" = (
/obj/machinery/power/terminal{
	dir = 8
	},
/obj/structure/cable{
	icon_state = "1-4"
	},
/obj/structure/cable{
	icon_state = "0-4"
	},
/turf/closed/wall/mineral/plastitanium,
/area/ship/bridge)
"M" = (
/obj/effect/decal/cleanable/dirt/dust,
/turf/open/floor/plating,
/area/ship/bridge)
"N" = (
/obj/structure/sign/poster/official/moth/piping,
/turf/closed/wall/mineral/plastitanium,
/area/ship/bridge)
"O" = (
/obj/machinery/autolathe,
/turf/open/floor/plating,
/area/ship/bridge)
"P" = (
/obj/structure/holosign/barrier/engineering,
/obj/effect/decal/cleanable/oil/slippery,
/turf/open/floor/plating,
/area/ship/bridge)
"R" = (
/obj/machinery/power/smes/engineering,
/turf/open/floor/plating,
/area/ship/bridge)
"S" = (
/obj/structure/cable{
	icon_state = "1-2"
	},
/obj/machinery/cryopod{
	alpha = 30;
	dir = 1
	},
/obj/machinery/computer/cryopod{
	pixel_y = -32
	},
/obj/machinery/light/broken,
/turf/open/floor/plating,
/area/ship/bridge)
"V" = (
/obj/machinery/light/broken,
/turf/open/floor/plating,
/area/ship/bridge)
"W" = (
/obj/effect/decal/cleanable/robot_debris,
/obj/effect/decal/cleanable/glass,
/turf/open/floor/plating,
/area/ship/bridge)
"X" = (
/obj/structure/cable{
	icon_state = "1-2"
	},
/turf/open/floor/plating,
/area/ship/bridge)
"Z" = (
/obj/structure/frame/computer,
/obj/item/shard,
/turf/open/floor/plating,
/area/ship/bridge)

(1,1,1) = {"
G
j
z
z
F
z
z
j
G
"}
(2,1,1) = {"
G
p
N
I
a
O
k
p
G
"}
(3,1,1) = {"
z
i
A
X
X
X
S
J
z
"}
(4,1,1) = {"
z
E
a
a
a
a
a
R
z
"}
(5,1,1) = {"
z
E
a
M
M
a
a
c
z
"}
(6,1,1) = {"
z
Z
W
P
M
M
a
a
z
"}
(7,1,1) = {"
z
E
a
M
a
y
D
a
z
"}
(8,1,1) = {"
z
q
a
a
C
e
d
V
z
"}
(9,1,1) = {"
z
a
D
M
M
v
M
M
z
"}
(10,1,1) = {"
z
r
r
r
r
r
r
r
z
"}
