//MAP CONVERTED BY dmm2tgm.py THIS HEADER COMMENT PREVENTS RECONVERSION, DO NOT REMOVE
"a" = (
/turf/closed/wall/mineral/titanium,
/area/ship/bridge)
"d" = (
/obj/structure/cable{
	icon_state = "2-8"
	},
/obj/structure/cable{
	icon_state = "1-8"
	},
/obj/structure/cable{
	icon_state = "4-8"
	},
/turf/open/floor/mineral/titanium/tiled/yellow,
/area/ship/bridge)
"e" = (
/obj/structure/cable{
	icon_state = "0-2"
	},
/obj/machinery/power/rtg/advanced,
/turf/open/floor/mineral/titanium/tiled/blue,
/area/ship/bridge)
"g" = (
/obj/structure/table/wood/reinforced,
/obj/item/circuitboard/computer/cargo/express,
/obj/item/circuitboard/machine/selling_pad,
/obj/item/circuitboard/computer/selling_pad_control,
/turf/open/floor/wood,
/area/ship/bridge)
"h" = (
/obj/effect/spawner/structure/window/shuttle,
/turf/open/floor/plating,
/area/ship/bridge)
"j" = (
/obj/structure/closet/crate/large{
	name = "circuitry crate"
	},
/obj/item/circuitboard/computer/communications,
/obj/item/circuitboard/computer/cargo/express,
/obj/item/circuitboard/machine/autolathe,
/obj/item/circuitboard/machine/microwave,
/obj/item/circuitboard/machine/ore_silo,
/obj/item/circuitboard/machine/pacman,
/obj/item/circuitboard/machine/pacman,
/obj/item/circuitboard/machine/pacman/uranium,
/obj/item/circuitboard/machine/pacman/uranium,
/obj/item/circuitboard/machine/pacman/diamond,
/obj/item/circuitboard/machine/shuttle/heater,
/obj/item/circuitboard/machine/shuttle/heater,
/obj/item/circuitboard/machine/shuttle/heater,
/obj/item/circuitboard/machine/shuttle/heater,
/obj/item/circuitboard/machine/shuttle/heater,
/obj/item/circuitboard/machine/shuttle/heater,
/obj/item/circuitboard/machine/shuttle/smes,
/obj/item/circuitboard/machine/shuttle/smes,
/obj/item/circuitboard/machine/shuttle/smes,
/obj/item/circuitboard/machine/shuttle/smes,
/obj/item/circuitboard/machine/shuttle/smes,
/obj/item/circuitboard/machine/shuttle/smes,
/obj/item/circuitboard/machine/shuttle/smes,
/obj/item/circuitboard/machine/shuttle/engine/electric,
/obj/item/circuitboard/machine/shuttle/engine/electric,
/obj/item/circuitboard/machine/shuttle/engine/electric,
/obj/item/circuitboard/machine/shuttle/engine/electric,
/obj/item/circuitboard/machine/shuttle/engine/electric,
/obj/item/circuitboard/machine/shuttle/engine/electric,
/obj/item/circuitboard/machine/shuttle/engine/plasma,
/obj/item/circuitboard/machine/shuttle/engine/plasma,
/obj/item/circuitboard/machine/shuttle/engine/plasma,
/obj/item/circuitboard/machine/shuttle/engine/plasma,
/obj/item/circuitboard/machine/shuttle/engine/plasma,
/obj/item/circuitboard/machine/shuttle/engine/plasma,
/obj/item/circuitboard/machine/thermomachine/freezer,
/obj/item/circuitboard/machine/thermomachine/heater,
/obj/item/circuitboard/machine/circulator,
/obj/item/circuitboard/machine/circulator,
/obj/item/circuitboard/computer/selling_pad_control,
/obj/item/circuitboard/machine/selling_pad,
/obj/item/storage/box/rndboards{
	name = "research boards";
	desc = "A box containing circuit boards for establishing research and development equipment."
	},
/obj/item/circuitboard/machine/smes,
/obj/item/circuitboard/machine/smes,
/obj/item/circuitboard/machine/smes,
/obj/item/circuitboard/machine/sleeper,
/obj/item/circuitboard/machine/sleeper,
/obj/item/circuitboard/machine/sleeper,
/obj/item/circuitboard/machine/generator,
/obj/item/circuitboard/machine/power_compressor,
/obj/item/circuitboard/machine/power_turbine,
/obj/item/circuitboard/computer/turbine_computer,
/obj/item/circuitboard/machine/ore_redemption,
/obj/machinery/light/small{
	dir = 1
	},
/turf/open/floor/mineral/titanium/tiled/yellow,
/area/ship/bridge)
"k" = (
/obj/structure/cable{
	icon_state = "2-8"
	},
/turf/open/floor/mineral/titanium/tiled/blue,
/area/ship/bridge)
"l" = (
/obj/machinery/computer/helm{
	dir = 8
	},
/obj/item/paper{
	info = "You are hereby assigned to build a station. get the fuck to work."
	},
/turf/open/floor/wood,
/area/ship/bridge)
"m" = (
/obj/machinery/computer/cryopod,
/obj/structure/table/wood/reinforced,
/turf/open/floor/wood,
/area/ship/bridge)
"p" = (
/obj/structure/closet/crate/large{
	name = "material crate"
	},
/obj/item/stack/sheet/mineral/titanium/fifty,
/obj/item/stack/sheet/mineral/titanium/fifty,
/obj/item/stack/sheet/mineral/titanium/fifty,
/obj/item/stack/sheet/mineral/titanium/fifty,
/obj/item/stack/sheet/metal/fifty,
/obj/item/stack/sheet/metal/fifty,
/obj/item/stack/sheet/metal/fifty,
/obj/item/stack/sheet/metal/fifty,
/obj/item/stack/sheet/metal/fifty,
/obj/item/stack/sheet/metal/fifty,
/obj/item/stack/sheet/metal/fifty,
/obj/item/stack/sheet/metal/fifty,
/obj/item/stack/sheet/mineral/plasma/fifty,
/obj/item/stack/sheet/mineral/plasma/fifty,
/obj/item/stack/sheet/mineral/silver/twenty,
/obj/item/stack/sheet/mineral/uranium/twenty,
/obj/item/stack/sheet/plasmarglass{
	amount = 25
	},
/obj/item/stack/sheet/titaniumglass{
	amount = 50
	},
/obj/item/stack/sheet/titaniumglass{
	amount = 50
	},
/obj/item/stack/sheet/titaniumglass{
	amount = 50
	},
/obj/item/stack/sheet/glass/fifty,
/obj/item/stack/sheet/glass/fifty,
/obj/item/stack/sheet/glass/fifty,
/obj/item/stack/sheet/glass/fifty,
/obj/item/stack/sheet/glass/fifty,
/obj/item/stack/sheet/glass/fifty,
/obj/item/stack/sheet/mineral/gold/twenty,
/obj/item/stack/sheet/mineral/diamond/five,
/obj/item/stack/cable_coil/red,
/obj/item/stack/cable_coil/red,
/obj/item/stack/cable_coil/red,
/obj/item/stack/cable_coil/red,
/obj/item/stack/cable_coil/red,
/obj/item/stack/cable_coil/red,
/turf/open/floor/mineral/titanium/tiled/yellow,
/area/ship/bridge)
"q" = (
/obj/structure/closet/crate/large{
	name = "atmospherics crate"
	},
/obj/item/pipe_dispenser,
/obj/item/pipe_dispenser,
/obj/item/pipe_dispenser,
/obj/item/paper{
	info = "DO NOT ACTIVATE THE GAS MINER TELEPORTERS OUTSIDE OF THE APPROPRIATE TANKS YOU FUCKING DIMWITS!!";
	color = "#ff0000";
	desc = "Seems important. That's why it's red."
	},
/obj/item/holosign_creator/atmos,
/obj/machinery/light/small,
/turf/open/floor/mineral/titanium/tiled/yellow,
/area/ship/bridge)
"r" = (
/turf/closed/wall/mineral/titanium/nodiagonal,
/area/ship/bridge)
"v" = (
/obj/structure/cable,
/obj/machinery/power/apc/auto_name/south,
/obj/machinery/cryopod{
	dir = 8
	},
/turf/open/floor/mineral/titanium/tiled/blue,
/area/ship/bridge)
"w" = (
/obj/machinery/cryopod{
	dir = 8
	},
/turf/open/floor/mineral/titanium/tiled/blue,
/area/ship/bridge)
"y" = (
/obj/item/construction/rcd/combat,
/obj/item/construction/rcd/combat,
/obj/item/construction/rcd/combat,
/obj/item/construction/rcd/combat,
/obj/item/construction/rcd/combat,
/obj/structure/closet/crate/large{
	name = "equipment crate"
	},
/obj/item/storage/toolbox/mechanical,
/obj/item/storage/toolbox/mechanical,
/obj/item/storage/toolbox/mechanical,
/obj/item/storage/toolbox/mechanical,
/obj/item/storage/toolbox/mechanical,
/obj/item/clothing/shoes/magboots,
/obj/item/clothing/shoes/magboots,
/obj/item/clothing/shoes/magboots,
/obj/item/clothing/shoes/magboots,
/obj/item/clothing/shoes/magboots,
/obj/item/clothing/suit/space/hardsuit/mining/independent,
/obj/item/clothing/suit/space/hardsuit/mining/independent,
/obj/item/clothing/suit/space/hardsuit/mining/independent,
/obj/item/clothing/suit/space/hardsuit/mining/independent,
/obj/item/clothing/suit/space/hardsuit/mining/independent,
/obj/item/clothing/mask/gas,
/obj/item/clothing/mask/gas,
/obj/item/clothing/mask/gas,
/obj/item/clothing/mask/gas,
/obj/item/clothing/mask/gas,
/obj/item/tank/internals/oxygen,
/obj/item/tank/internals/oxygen,
/obj/item/tank/internals/oxygen,
/obj/item/tank/internals/oxygen,
/obj/item/tank/internals/oxygen,
/obj/item/tank/jetpack/oxygen,
/obj/item/tank/jetpack/oxygen,
/obj/item/tank/jetpack/oxygen,
/obj/item/tank/jetpack/oxygen,
/obj/item/tank/jetpack/oxygen,
/obj/item/clothing/gloves/color/yellow,
/obj/item/clothing/gloves/color/yellow,
/obj/item/clothing/gloves/color/yellow,
/obj/item/clothing/gloves/color/yellow,
/obj/machinery/light/small,
/obj/item/clothing/gloves/color/yellow,
/obj/structure/cable,
/obj/machinery/power/terminal{
	dir = 8
	},
/turf/open/floor/mineral/titanium/tiled/yellow,
/area/ship/bridge)
"z" = (
/obj/structure/closet/crate/large{
	name = "miscellaneous crate"
	},
/obj/item/reagent_containers/food/snacks/rationpack,
/obj/item/reagent_containers/food/snacks/rationpack,
/obj/item/reagent_containers/food/snacks/rationpack,
/obj/item/reagent_containers/food/snacks/rationpack,
/obj/item/reagent_containers/food/snacks/rationpack,
/obj/item/reagent_containers/food/snacks/rationpack,
/obj/item/reagent_containers/food/snacks/rationpack,
/obj/item/reagent_containers/food/snacks/rationpack,
/obj/item/reagent_containers/food/snacks/rationpack,
/obj/item/reagent_containers/food/snacks/rationpack,
/obj/item/vending_refill/security,
/obj/item/vending_refill/security,
/obj/item/vending_refill/security,
/obj/item/storage/backpack/duffelbag/syndie/surgery,
/obj/item/reagent_containers/glass/bottle/antitoxin/sleeper,
/obj/item/reagent_containers/glass/bottle/bicaridine/sleeper,
/obj/item/reagent_containers/glass/bottle/dexalin/sleeper,
/obj/item/reagent_containers/glass/bottle/epinephrine/sleeper,
/obj/item/reagent_containers/glass/bottle/kelotane/sleeper,
/obj/item/reagent_containers/glass/bottle/morphine/sleeper,
/obj/item/storage/bag/chemistry,
/obj/machinery/light/small{
	dir = 1
	},
/obj/structure/cable{
	icon_state = "0-2"
	},
/obj/machinery/power/terminal{
	dir = 8
	},
/turf/open/floor/mineral/titanium/tiled/yellow,
/area/ship/bridge)
"A" = (
/obj/structure/closet/crate/large{
	name = "parts crate"
	},
/obj/item/storage/part_replacer/cargo,
/obj/item/storage/part_replacer/cargo,
/obj/item/storage/part_replacer/cargo,
/obj/item/storage/box/stockparts/basic,
/obj/item/storage/box/stockparts/basic,
/obj/item/storage/box/stockparts/basic,
/obj/item/storage/box/stockparts/basic,
/obj/item/storage/box/stockparts/basic,
/obj/item/storage/box/stockparts/basic,
/obj/item/storage/box/stockparts/basic,
/obj/item/storage/box/stockparts/basic,
/obj/item/storage/box/stockparts/basic,
/obj/item/storage/box/stockparts/basic,
/obj/item/storage/box/stockparts/t2,
/obj/item/storage/box/stockparts/t2,
/obj/item/assembly/igniter,
/obj/item/stock_parts/cell/high/plus{
	charge = 15000
	},
/obj/item/stock_parts/cell/high/plus{
	charge = 15000
	},
/obj/item/stock_parts/cell/high/plus{
	charge = 15000
	},
/obj/item/stock_parts/cell/high/plus{
	charge = 15000
	},
/obj/item/stock_parts/cell/high/plus{
	charge = 15000
	},
/obj/item/stock_parts/cell/high/plus{
	charge = 15000
	},
/obj/item/stock_parts/cell/high/plus{
	charge = 15000
	},
/obj/item/stock_parts/cell/high/plus{
	charge = 15000
	},
/obj/item/stock_parts/cell/high/plus{
	charge = 15000
	},
/obj/item/stock_parts/cell/high/plus{
	charge = 15000
	},
/obj/item/stock_parts/cell/high/plus{
	charge = 15000
	},
/obj/item/stock_parts/cell/high/plus{
	charge = 15000
	},
/obj/item/stock_parts/cell/high/plus{
	charge = 15000
	},
/obj/item/stock_parts/cell/high/plus{
	charge = 15000
	},
/obj/item/stock_parts/cell/high/plus{
	charge = 15000
	},
/obj/item/stock_parts/cell/high/plus{
	charge = 15000
	},
/obj/item/stock_parts/cell/high/plus{
	charge = 15000
	},
/obj/item/stock_parts/cell/high/plus{
	charge = 15000
	},
/obj/item/stock_parts/cell/high/plus{
	charge = 15000
	},
/obj/item/stock_parts/cell/high/plus{
	charge = 15000
	},
/obj/item/stock_parts/subspace/amplifier,
/obj/item/stock_parts/subspace/amplifier,
/obj/item/stock_parts/subspace/transmitter,
/obj/item/stock_parts/subspace/transmitter,
/obj/item/stock_parts/subspace/crystal,
/turf/open/floor/mineral/titanium/tiled/yellow,
/area/ship/bridge)
"B" = (
/obj/machinery/light/small{
	dir = 1
	},
/obj/structure/cable{
	icon_state = "0-2"
	},
/obj/machinery/power/rtg/advanced,
/turf/open/floor/mineral/titanium/tiled/yellow,
/area/ship/bridge)
"C" = (
/obj/machinery/light/small,
/obj/machinery/cryopod{
	dir = 4
	},
/turf/open/floor/mineral/titanium/tiled/blue,
/area/ship/bridge)
"D" = (
/obj/machinery/door/airlock/titanium,
/obj/structure/fans/tiny,
/turf/open/floor/plating,
/area/ship/bridge)
"E" = (
/obj/structure/cable{
	icon_state = "0-8"
	},
/obj/machinery/power/smes/shuttle/precharged{
	dir = 4
	},
/obj/effect/turf_decal/industrial/warning{
	dir = 4
	},
/obj/effect/turf_decal/techfloor{
	dir = 8
	},
/obj/machinery/door/window/eastleft{
	name = "Engine Access"
	},
/obj/structure/window/reinforced{
	dir = 8
	},
/turf/open/floor/plating,
/area/ship/bridge)
"F" = (
/turf/open/floor/mineral/titanium/tiled/blue,
/area/ship/bridge)
"G" = (
/obj/structure/cable{
	icon_state = "4-8"
	},
/turf/open/floor/mineral/titanium/tiled/yellow,
/area/ship/bridge)
"I" = (
/obj/machinery/door/airlock/titanium,
/obj/structure/fans/tiny,
/obj/docking_port/mobile{
	dir = 2;
	launch_status = 0;
	port_direction = 8;
	preferred_direction = 4
	},
/turf/open/floor/plating,
/area/ship/bridge)
"J" = (
/turf/open/floor/wood,
/area/ship/bridge)
"L" = (
/obj/structure/cable,
/obj/machinery/power/rtg/advanced,
/turf/open/floor/mineral/titanium/tiled/blue,
/area/ship/bridge)
"M" = (
/obj/structure/cable{
	icon_state = "4-8"
	},
/turf/open/floor/mineral/titanium/tiled/blue,
/area/ship/bridge)
"O" = (
/obj/machinery/light/small,
/obj/structure/cable,
/obj/machinery/power/rtg/advanced,
/turf/open/floor/mineral/titanium/tiled/yellow,
/area/ship/bridge)
"P" = (
/obj/structure/cable{
	icon_state = "2-4"
	},
/obj/structure/cable{
	icon_state = "1-4"
	},
/obj/structure/cable{
	icon_state = "0-4"
	},
/obj/machinery/power/terminal{
	dir = 8
	},
/turf/open/floor/mineral/titanium/tiled/yellow,
/area/ship/bridge)
"S" = (
/obj/structure/closet/secure_closet/captains,
/turf/open/floor/wood,
/area/ship/bridge)
"W" = (
/turf/open/floor/mineral/titanium/tiled/yellow,
/area/ship/bridge)
"X" = (
/obj/structure/cable{
	icon_state = "1-8"
	},
/obj/structure/cable{
	icon_state = "2-8"
	},
/obj/structure/cable{
	icon_state = "4-8"
	},
/turf/open/floor/mineral/titanium/tiled/blue,
/area/ship/bridge)
"Y" = (
/obj/structure/cable{
	icon_state = "0-4"
	},
/obj/machinery/power/shuttle/engine/electric{
	dir = 4
	},
/turf/open/floor/plating,
/area/ship/bridge)
"Z" = (
/obj/machinery/light/small{
	dir = 1
	},
/obj/machinery/cryopod{
	dir = 4
	},
/turf/open/floor/mineral/titanium/tiled/blue,
/area/ship/bridge)

(1,1,1) = {"
r
Y
Y
Y
r
"}
(2,1,1) = {"
r
E
E
E
r
"}
(3,1,1) = {"
r
z
P
y
r
"}
(4,1,1) = {"
D
W
G
W
D
"}
(5,1,1) = {"
a
A
G
p
a
"}
(6,1,1) = {"
a
j
G
q
a
"}
(7,1,1) = {"
I
W
G
W
D
"}
(8,1,1) = {"
a
B
d
O
a
"}
(9,1,1) = {"
a
e
X
L
a
"}
(10,1,1) = {"
D
F
M
F
D
"}
(11,1,1) = {"
a
w
k
v
a
"}
(12,1,1) = {"
a
Z
F
C
a
"}
(13,1,1) = {"
h
J
J
m
h
"}
(14,1,1) = {"
h
S
l
g
h
"}
(15,1,1) = {"
h
h
h
h
h
"}
