//MAP CONVERTED BY dmm2tgm.py THIS HEADER COMMENT PREVENTS RECONVERSION, DO NOT REMOVE
"a" = (
/turf/open/floor/iron/tech,
/area/ship/construction)
"c" = (
/obj/machinery/cryopod,
/obj/machinery/computer/cryopod{
	pixel_y = -32
	},
/turf/open/floor/iron/tech,
/area/ship/construction)
"e" = (
/obj/structure/closet/crate/large{
	name = "parts crate"
	},
/obj/item/storage/part_replacer/cargo,
/obj/item/storage/part_replacer/cargo,
/obj/item/storage/part_replacer/cargo,
/obj/item/storage/box/stockparts/basic,
/obj/item/storage/box/stockparts/basic,
/obj/item/storage/box/stockparts/basic,
/obj/item/storage/box/stockparts/basic,
/obj/item/storage/box/stockparts/basic,
/obj/item/storage/box/stockparts/basic,
/obj/item/storage/box/stockparts/basic,
/obj/item/storage/box/stockparts/basic,
/obj/item/storage/box/stockparts/basic,
/obj/item/storage/box/stockparts/basic,
/obj/item/storage/box/stockparts/t2,
/obj/item/storage/box/stockparts/t2,
/obj/item/assembly/igniter,
/obj/item/stock_parts/cell/high/plus{
	charge = 15000
	},
/obj/item/stock_parts/cell/high/plus{
	charge = 15000
	},
/obj/item/stock_parts/cell/high/plus{
	charge = 15000
	},
/obj/item/stock_parts/cell/high/plus{
	charge = 15000
	},
/obj/item/stock_parts/cell/high/plus{
	charge = 15000
	},
/obj/item/stock_parts/cell/high/plus{
	charge = 15000
	},
/obj/item/stock_parts/cell/high/plus{
	charge = 15000
	},
/obj/item/stock_parts/cell/high/plus{
	charge = 15000
	},
/obj/item/stock_parts/cell/high/plus{
	charge = 15000
	},
/obj/item/stock_parts/cell/high/plus{
	charge = 15000
	},
/obj/item/stock_parts/cell/high/plus{
	charge = 15000
	},
/obj/item/stock_parts/cell/high/plus{
	charge = 15000
	},
/obj/item/stock_parts/cell/high/plus{
	charge = 15000
	},
/obj/item/stock_parts/cell/high/plus{
	charge = 15000
	},
/obj/item/stock_parts/cell/high/plus{
	charge = 15000
	},
/obj/item/stock_parts/cell/high/plus{
	charge = 15000
	},
/obj/item/stock_parts/cell/high/plus{
	charge = 15000
	},
/obj/item/stock_parts/cell/high/plus{
	charge = 15000
	},
/obj/item/stock_parts/cell/high/plus{
	charge = 15000
	},
/obj/item/stock_parts/cell/high/plus{
	charge = 15000
	},
/obj/item/stock_parts/subspace/amplifier,
/obj/item/stock_parts/subspace/amplifier,
/obj/item/stock_parts/subspace/transmitter,
/obj/item/stock_parts/subspace/transmitter,
/obj/item/stock_parts/subspace/crystal,
/turf/open/floor/iron/tech,
/area/ship/construction)
"g" = (
/obj/structure/catwalk/over,
/obj/structure/railing{
	dir = 10
	},
/turf/open/floor/plating/airless,
/area/ship/external)
"i" = (
/obj/structure/closet/crate/large{
	name = "miscellaneous crate"
	},
/obj/structure/cable{
	icon_state = "2-8"
	},
/obj/item/reagent_containers/food/snacks/rationpack,
/obj/item/reagent_containers/food/snacks/rationpack,
/obj/item/reagent_containers/food/snacks/rationpack,
/obj/item/reagent_containers/food/snacks/rationpack,
/obj/item/reagent_containers/food/snacks/rationpack,
/obj/item/reagent_containers/food/snacks/rationpack,
/obj/item/reagent_containers/food/snacks/rationpack,
/obj/item/reagent_containers/food/snacks/rationpack,
/obj/item/reagent_containers/food/snacks/rationpack,
/obj/item/reagent_containers/food/snacks/rationpack,
/obj/item/vending_refill/security,
/obj/item/vending_refill/security,
/obj/item/vending_refill/security,
/obj/item/storage/backpack/duffelbag/syndie/surgery,
/obj/item/reagent_containers/glass/bottle/antitoxin/sleeper,
/obj/item/reagent_containers/glass/bottle/bicaridine/sleeper,
/obj/item/reagent_containers/glass/bottle/dexalin/sleeper,
/obj/item/reagent_containers/glass/bottle/epinephrine/sleeper,
/obj/item/reagent_containers/glass/bottle/kelotane/sleeper,
/obj/item/reagent_containers/glass/bottle/morphine/sleeper,
/obj/item/storage/bag/chemistry,
/turf/open/floor/iron/tech,
/area/ship/construction)
"k" = (
/obj/structure/closet/crate/medical,
/obj/item/storage/firstaid/brute,
/obj/item/storage/firstaid/fire,
/obj/item/storage/firstaid/medical,
/obj/item/defibrillator/loaded,
/obj/structure/cable{
	icon_state = "4-8"
	},
/turf/open/floor/iron/tech,
/area/ship/construction)
"l" = (
/obj/structure/cable{
	icon_state = "1-8"
	},
/obj/structure/cable{
	icon_state = "4-8"
	},
/turf/open/floor/iron/tech,
/area/ship/construction)
"m" = (
/obj/structure/cable{
	icon_state = "0-2"
	},
/obj/machinery/power/terminal{
	dir = 8
	},
/turf/open/floor/iron/tech,
/area/ship/construction)
"n" = (
/obj/structure/table/reinforced,
/obj/item/gps{
	pixel_x = 7
	},
/obj/item/areaeditor/shuttle,
/turf/open/floor/iron/tech,
/area/ship/construction)
"o" = (
/obj/machinery/vending/security/marine{
	all_items_free = 1
	},
/obj/machinery/light/small{
	dir = 1
	},
/turf/open/floor/iron/tech,
/area/ship/construction)
"p" = (
/obj/machinery/power/apc/auto_name/south,
/obj/structure/closet/crate/large{
	name = "atmospherics crate"
	},
/obj/item/sbeacondrop/atmospherics/nitrogen_miner,
/obj/item/sbeacondrop/atmospherics/oxygen_miner,
/obj/item/sbeacondrop/atmospherics/plasma_miner,
/obj/item/pipe_dispenser,
/obj/item/pipe_dispenser,
/obj/item/pipe_dispenser,
/obj/structure/cable,
/obj/item/paper{
	info = "DO NOT ACTIVATE THE GAS MINER TELEPORTERS OUTSIDE OF THE APPROPRIATE TANKS YOU FUCKING DIMWITS!!";
	color = "#ff0000";
	desc = "Seems important. That's why it's red."
	},
/obj/item/holosign_creator/atmos,
/turf/open/floor/iron/tech,
/area/ship/construction)
"q" = (
/obj/machinery/computer/helm,
/turf/open/floor/iron/tech,
/area/ship/construction)
"s" = (
/obj/structure/catwalk/over,
/obj/structure/railing{
	dir = 8
	},
/turf/open/floor/plating/airless,
/area/ship/external)
"t" = (
/obj/structure/cable{
	icon_state = "0-2"
	},
/obj/structure/cable{
	icon_state = "1-2"
	},
/obj/machinery/power/terminal{
	dir = 8
	},
/turf/open/floor/iron/tech,
/area/ship/construction)
"v" = (
/obj/machinery/door/airlock/hatch{
	name = "external airlock"
	},
/obj/structure/fans/tiny,
/turf/open/floor/iron/tech,
/area/ship/construction)
"z" = (
/obj/machinery/power/port_gen/pacman,
/obj/item/stack/sheet/mineral/plasma/fifty,
/obj/structure/cable,
/obj/machinery/power/terminal{
	dir = 1
	},
/turf/open/floor/iron/tech,
/area/ship/construction)
"B" = (
/obj/structure/closet/crate/large{
	name = "material crate"
	},
/obj/item/stack/sheet/mineral/plastitanium{
	amount = 50
	},
/obj/item/stack/sheet/mineral/plastitanium{
	amount = 50
	},
/obj/item/stack/sheet/mineral/plastitanium{
	amount = 50
	},
/obj/item/stack/sheet/mineral/plastitanium{
	amount = 50
	},
/obj/item/stack/sheet/metal/fifty,
/obj/item/stack/sheet/metal/fifty,
/obj/item/stack/sheet/metal/fifty,
/obj/item/stack/sheet/metal/fifty,
/obj/item/stack/sheet/metal/fifty,
/obj/item/stack/sheet/metal/fifty,
/obj/item/stack/sheet/metal/fifty,
/obj/item/stack/sheet/metal/fifty,
/obj/item/stack/sheet/mineral/plasma/fifty,
/obj/item/stack/sheet/mineral/plasma/fifty,
/obj/item/stack/sheet/mineral/silver/twenty,
/obj/item/stack/sheet/mineral/uranium/twenty,
/obj/item/stack/sheet/plasmarglass{
	amount = 25
	},
/obj/item/stack/sheet/plastitaniumglass{
	amount = 50
	},
/obj/item/stack/sheet/plastitaniumglass{
	amount = 50
	},
/obj/item/stack/sheet/plastitaniumglass{
	amount = 50
	},
/obj/item/stack/sheet/glass/fifty,
/obj/item/stack/sheet/glass/fifty,
/obj/item/stack/sheet/glass/fifty,
/obj/item/stack/sheet/glass/fifty,
/obj/item/stack/sheet/glass/fifty,
/obj/item/stack/sheet/glass/fifty,
/obj/item/stack/sheet/mineral/gold/twenty,
/obj/item/stack/sheet/mineral/diamond/five,
/obj/item/stack/cable_coil/red,
/obj/item/stack/cable_coil/red,
/obj/item/stack/cable_coil/red,
/obj/item/stack/cable_coil/red,
/obj/item/stack/cable_coil/red,
/obj/item/stack/cable_coil/red,
/turf/open/floor/iron/tech,
/area/ship/construction)
"C" = (
/obj/structure/window/reinforced/spawner/west,
/obj/machinery/power/smes/shuttle/precharged{
	dir = 4
	},
/obj/structure/cable{
	icon_state = "0-8"
	},
/obj/machinery/door/window/eastleft{
	name = "Engine Access"
	},
/obj/structure/window/reinforced/spawner/north,
/turf/open/floor/plating,
/area/ship/construction)
"D" = (
/obj/effect/spawner/structure/window/plasma/reinforced/plastitanium,
/turf/open/floor/plating,
/area/ship/construction)
"E" = (
/obj/structure/closet/crate/large{
	name = "circuitry crate"
	},
/obj/item/circuitboard/computer/communications,
/obj/item/circuitboard/computer/cargo/express,
/obj/item/circuitboard/machine/autolathe,
/obj/item/circuitboard/machine/microwave,
/obj/item/circuitboard/machine/ore_silo,
/obj/item/circuitboard/machine/pacman,
/obj/item/circuitboard/machine/pacman,
/obj/item/circuitboard/machine/pacman/uranium,
/obj/item/circuitboard/machine/pacman/uranium,
/obj/item/circuitboard/machine/pacman/diamond,
/obj/item/circuitboard/machine/shuttle/heater,
/obj/item/circuitboard/machine/shuttle/heater,
/obj/item/circuitboard/machine/shuttle/heater,
/obj/item/circuitboard/machine/shuttle/heater,
/obj/item/circuitboard/machine/shuttle/heater,
/obj/item/circuitboard/machine/shuttle/heater,
/obj/item/circuitboard/machine/shuttle/smes,
/obj/item/circuitboard/machine/shuttle/smes,
/obj/item/circuitboard/machine/shuttle/smes,
/obj/item/circuitboard/machine/shuttle/smes,
/obj/item/circuitboard/machine/shuttle/smes,
/obj/item/circuitboard/machine/shuttle/smes,
/obj/item/circuitboard/machine/shuttle/smes,
/obj/item/circuitboard/machine/shuttle/engine/electric,
/obj/item/circuitboard/machine/shuttle/engine/electric,
/obj/item/circuitboard/machine/shuttle/engine/electric,
/obj/item/circuitboard/machine/shuttle/engine/electric,
/obj/item/circuitboard/machine/shuttle/engine/electric,
/obj/item/circuitboard/machine/shuttle/engine/electric,
/obj/item/circuitboard/machine/shuttle/engine/plasma,
/obj/item/circuitboard/machine/shuttle/engine/plasma,
/obj/item/circuitboard/machine/shuttle/engine/plasma,
/obj/item/circuitboard/machine/shuttle/engine/plasma,
/obj/item/circuitboard/machine/shuttle/engine/plasma,
/obj/item/circuitboard/machine/shuttle/engine/plasma,
/obj/item/circuitboard/machine/thermomachine/freezer,
/obj/item/circuitboard/machine/thermomachine/heater,
/obj/item/circuitboard/machine/circulator,
/obj/item/circuitboard/machine/circulator,
/obj/item/circuitboard/computer/selling_pad_control,
/obj/item/circuitboard/machine/selling_pad,
/obj/item/storage/box/rndboards{
	name = "research boards";
	desc = "A box containing circuit boards for establishing research and development equipment."
	},
/obj/item/circuitboard/machine/smes,
/obj/item/circuitboard/machine/smes,
/obj/item/circuitboard/machine/smes,
/obj/item/circuitboard/machine/sleeper,
/obj/item/circuitboard/machine/sleeper,
/obj/item/circuitboard/machine/sleeper,
/obj/machinery/light/small,
/obj/item/circuitboard/machine/generator,
/obj/item/circuitboard/machine/power_compressor,
/obj/item/circuitboard/machine/power_turbine,
/obj/item/circuitboard/computer/turbine_computer,
/obj/item/circuitboard/machine/ore_redemption,
/turf/open/floor/iron/tech,
/area/ship/construction)
"F" = (
/obj/structure/cable{
	icon_state = "0-4"
	},
/obj/machinery/power/smes/engineering,
/turf/open/floor/iron/tech,
/area/ship/construction)
"G" = (
/obj/machinery/power/shuttle/engine/electric{
	dir = 4
	},
/obj/structure/cable{
	icon_state = "0-4"
	},
/obj/structure/window/reinforced/spawner,
/turf/open/floor/plating,
/area/ship/construction)
"H" = (
/obj/machinery/power/shuttle/engine/electric{
	dir = 4
	},
/obj/structure/cable{
	icon_state = "0-4"
	},
/obj/structure/window/reinforced/spawner/north,
/turf/open/floor/plating,
/area/ship/construction)
"N" = (
/obj/structure/catwalk/over,
/obj/structure/railing{
	dir = 9
	},
/turf/open/floor/plating/airless,
/area/ship/external)
"O" = (
/obj/structure/closet/secure_closet{
	anchored = 1;
	icon_state = "hos";
	name = "captain's locker";
	req_access_txt = "20"
	},
/obj/item/storage/backpack/security,
/obj/item/clothing/under/syndicate/combat,
/obj/item/clothing/suit/armor/vest/capcarapace/syndicate,
/obj/item/clothing/shoes/jackboots,
/obj/item/clothing/gloves/combat,
/obj/item/clothing/glasses/thermal/eyepatch,
/obj/item/clothing/head/HoS/syndicate,
/obj/item/codespeak_manual/unlimited,
/obj/item/pen/edagger,
/obj/effect/decal/cleanable/dirt/dust,
/obj/item/ammo_box/a357,
/obj/item/ammo_box/a357,
/obj/item/gun/ballistic/revolver/mateba,
/obj/item/clothing/suit/space/hardsuit/syndi/elite,
/obj/item/construction/rcd/arcd,
/obj/machinery/airalarm/all_access{
	pixel_y = 24
	},
/turf/open/floor/iron/tech,
/area/ship/construction)
"P" = (
/turf/closed/wall/mineral/plastitanium/nodiagonal,
/area/ship/construction)
"R" = (
/turf/template_noop,
/area/template_noop)
"U" = (
/obj/docking_port/mobile{
	can_move_docking_ports = 1;
	dir = 2;
	dwidth = 9;
	height = 6;
	launch_status = 0;
	port_direction = 8;
	preferred_direction = 4;
	width = 9
	},
/obj/machinery/door/airlock/hatch{
	name = "external airlock"
	},
/obj/structure/fans/tiny,
/turf/open/floor/iron/tech,
/area/ship/construction)
"W" = (
/obj/structure/window/reinforced/spawner/west,
/obj/machinery/power/smes/shuttle/precharged{
	dir = 4
	},
/obj/structure/cable{
	icon_state = "0-8"
	},
/obj/machinery/door/window/eastleft{
	name = "Engine Access"
	},
/obj/structure/window/reinforced/spawner,
/turf/open/floor/plating,
/area/ship/construction)
"Z" = (
/obj/item/construction/rcd/combat{
	name = "syndicate RCD";
	desc = "A high-capacity Syndicate-made RCD."
	},
/obj/item/construction/rcd/combat{
	name = "syndicate RCD";
	desc = "A high-capacity Syndicate-made RCD."
	},
/obj/item/construction/rcd/combat{
	name = "syndicate RCD";
	desc = "A high-capacity Syndicate-made RCD."
	},
/obj/item/construction/rcd/combat{
	name = "syndicate RCD";
	desc = "A high-capacity Syndicate-made RCD."
	},
/obj/item/construction/rcd/combat{
	name = "syndicate RCD";
	desc = "A high-capacity Syndicate-made RCD."
	},
/obj/structure/closet/crate/large{
	name = "equipment crate"
	},
/obj/item/storage/toolbox/syndicate,
/obj/item/storage/toolbox/syndicate,
/obj/item/storage/toolbox/syndicate,
/obj/item/storage/toolbox/syndicate,
/obj/item/storage/toolbox/syndicate,
/obj/item/clothing/shoes/magboots/syndie,
/obj/item/clothing/shoes/magboots/syndie,
/obj/item/clothing/shoes/magboots/syndie,
/obj/item/clothing/shoes/magboots/syndie,
/obj/item/clothing/shoes/magboots/syndie,
/obj/item/clothing/suit/space/hardsuit/syndi,
/obj/item/clothing/suit/space/hardsuit/syndi,
/obj/item/clothing/suit/space/hardsuit/syndi,
/obj/item/clothing/suit/space/hardsuit/syndi,
/obj/item/clothing/suit/space/hardsuit/syndi,
/obj/item/clothing/mask/gas/syndicate,
/obj/item/clothing/mask/gas/syndicate,
/obj/item/clothing/mask/gas/syndicate,
/obj/item/clothing/mask/gas/syndicate,
/obj/item/clothing/mask/gas/syndicate,
/obj/item/tank/internals/oxygen,
/obj/item/tank/internals/oxygen,
/obj/item/tank/internals/oxygen,
/obj/item/tank/internals/oxygen,
/obj/item/tank/internals/oxygen,
/obj/item/tank/jetpack/oxygen/harness,
/obj/item/tank/jetpack/oxygen/harness,
/obj/item/tank/jetpack/oxygen/harness,
/obj/item/tank/jetpack/oxygen/harness,
/obj/item/tank/jetpack/oxygen/harness,
/turf/open/floor/iron/tech,
/area/ship/construction)

(1,1,1) = {"
R
R
R
N
s
g
"}
(2,1,1) = {"
P
H
G
P
v
P
"}
(3,1,1) = {"
P
C
W
F
z
P
"}
(4,1,1) = {"
U
m
t
l
a
v
"}
(5,1,1) = {"
P
o
a
k
c
P
"}
(6,1,1) = {"
P
O
a
i
p
P
"}
(7,1,1) = {"
D
q
a
e
E
P
"}
(8,1,1) = {"
D
n
a
Z
B
P
"}
(9,1,1) = {"
D
D
D
P
P
P
"}
