//MAP CONVERTED BY dmm2tgm.py THIS HEADER COMMENT PREVENTS RECONVERSION, DO NOT REMOVE
"a" = (
/obj/structure/cable{
	icon_state = "1-8"
	},
/obj/structure/cable{
	icon_state = "2-8"
	},
/turf/open/floor/mineral/titanium/tiled,
/area/ship/bridge)
"b" = (
/obj/machinery/door/window/northright,
/obj/machinery/power/terminal{
	dir = 4
	},
/obj/structure/cable{
	icon_state = "0-2"
	},
/obj/structure/fans/tiny,
/turf/open/floor/mineral/titanium/tiled/white,
/area/ship/bridge)
"c" = (
/obj/machinery/door/window/northleft,
/obj/structure/fans/tiny,
/turf/open/floor/mineral/titanium/tiled/white,
/area/ship/bridge)
"e" = (
/obj/machinery/power/smes/shuttle/precharged{
	dir = 8
	},
/obj/structure/window/reinforced{
	dir = 4
	},
/obj/structure/window/reinforced{
	dir = 1
	},
/obj/structure/cable{
	icon_state = "0-4"
	},
/turf/open/floor/plating,
/area/ship/bridge)
"f" = (
/obj/structure/chair/comfy/shuttle{
	dir = 1
	},
/obj/machinery/light,
/turf/open/floor/mineral/titanium/tiled/blue,
/area/ship/bridge)
"g" = (
/obj/machinery/power/shuttle/engine/electric{
	dir = 8
	},
/obj/structure/cable{
	icon_state = "0-8"
	},
/turf/open/floor/plating,
/area/ship/external)
"h" = (
/obj/machinery/door/window/southright,
/obj/machinery/power/terminal{
	dir = 4
	},
/obj/structure/cable,
/obj/structure/fans/tiny,
/turf/open/floor/mineral/titanium/tiled/white,
/area/ship/bridge)
"i" = (
/obj/machinery/door/window/southright,
/obj/structure/fans/tiny,
/turf/open/floor/mineral/titanium/tiled/white,
/area/ship/bridge)
"k" = (
/obj/machinery/power/terminal{
	dir = 1
	},
/obj/machinery/power/port_gen/pacman,
/obj/structure/cable,
/obj/machinery/computer/cryopod{
	pixel_x = -32
	},
/turf/open/floor/mineral/titanium/tiled,
/area/ship/bridge)
"l" = (
/obj/machinery/power/shuttle/engine/electric{
	dir = 4
	},
/obj/structure/cable{
	icon_state = "0-4"
	},
/turf/open/floor/plating,
/area/ship/external)
"p" = (
/obj/machinery/door/window/northleft,
/obj/machinery/power/terminal{
	dir = 8
	},
/obj/structure/cable{
	icon_state = "0-2"
	},
/obj/structure/fans/tiny,
/turf/open/floor/mineral/titanium/tiled/white,
/area/ship/bridge)
"r" = (
/obj/structure/cable{
	icon_state = "4-8"
	},
/turf/open/floor/mineral/titanium/tiled,
/area/ship/bridge)
"s" = (
/obj/structure/cable{
	icon_state = "0-4"
	},
/obj/machinery/power/apc/auto_name/west,
/obj/machinery/cryopod{
	dir = 1
	},
/turf/open/floor/mineral/titanium/tiled/blue,
/area/ship/bridge)
"t" = (
/obj/machinery/power/smes/shuttle/precharged{
	dir = 4
	},
/obj/structure/window/reinforced{
	dir = 8
	},
/obj/structure/window/reinforced{
	dir = 1
	},
/obj/structure/cable{
	icon_state = "0-8"
	},
/turf/open/floor/plating,
/area/ship/bridge)
"u" = (
/obj/structure/chair/comfy/shuttle{
	dir = 8
	},
/turf/open/floor/mineral/titanium/tiled,
/area/ship/bridge)
"v" = (
/obj/structure/cable{
	icon_state = "1-2"
	},
/turf/open/floor/mineral/titanium/tiled,
/area/ship/bridge)
"w" = (
/obj/machinery/door/window/southleft,
/obj/structure/fans/tiny,
/turf/open/floor/mineral/titanium/tiled/white,
/area/ship/bridge)
"x" = (
/obj/structure/grille,
/obj/structure/window/shuttle,
/turf/open/floor/plating,
/area/ship/bridge)
"z" = (
/obj/structure/cable{
	icon_state = "4-8"
	},
/obj/structure/cable{
	icon_state = "1-8"
	},
/obj/structure/cable{
	icon_state = "2-8"
	},
/turf/open/floor/mineral/titanium/tiled,
/area/ship/bridge)
"A" = (
/obj/machinery/power/smes/shuttle/precharged{
	dir = 8
	},
/obj/structure/window/reinforced{
	dir = 4
	},
/obj/structure/window/reinforced,
/obj/structure/cable{
	icon_state = "0-4"
	},
/turf/open/floor/plating,
/area/ship/bridge)
"C" = (
/obj/structure/chair/comfy/shuttle{
	dir = 8
	},
/turf/open/floor/mineral/titanium/tiled/blue,
/area/ship/bridge)
"E" = (
/turf/closed/wall/mineral/titanium,
/area/ship/bridge)
"H" = (
/obj/structure/cable{
	icon_state = "4-8"
	},
/obj/structure/chair/comfy/shuttle,
/obj/machinery/light{
	dir = 1
	},
/turf/open/floor/mineral/titanium/tiled/blue,
/area/ship/bridge)
"I" = (
/obj/structure/grille,
/obj/structure/window/shuttle,
/obj/docking_port/mobile{
	can_move_docking_ports = 1;
	dir = 8;
	launch_status = 0
	},
/turf/open/floor/plating,
/area/ship/bridge)
"K" = (
/obj/machinery/computer/helm,
/turf/open/floor/mineral/titanium/tiled,
/area/ship/bridge)
"L" = (
/obj/structure/cable{
	icon_state = "1-8"
	},
/obj/structure/cable{
	icon_state = "1-2"
	},
/turf/open/floor/mineral/titanium/tiled,
/area/ship/bridge)
"N" = (
/obj/machinery/door/window/southleft,
/obj/machinery/power/terminal{
	dir = 8
	},
/obj/structure/cable,
/obj/structure/fans/tiny,
/turf/open/floor/mineral/titanium/tiled/white,
/area/ship/bridge)
"S" = (
/obj/structure/closet/crate,
/obj/item/storage/toolbox/mechanical,
/obj/item/stack/cable_coil/red,
/obj/item/stack/sheet/metal/ten,
/obj/item/stack/sheet/glass{
	amount = 10
	},
/obj/item/circuitboard/machine/autolathe,
/obj/item/storage/box/stockparts/basic,
/obj/item/pickaxe,
/obj/item/pickaxe,
/obj/item/pickaxe,
/obj/item/mining_scanner,
/obj/item/mining_scanner,
/obj/item/mining_scanner,
/obj/item/stack/sheet/mineral/plasma/five,
/obj/item/areaeditor/shuttle,
/turf/open/floor/mineral/titanium/tiled,
/area/ship/bridge)
"U" = (
/obj/machinery/power/smes,
/obj/structure/cable{
	icon_state = "0-4"
	},
/turf/open/floor/mineral/titanium/tiled/blue,
/area/ship/bridge)
"V" = (
/obj/machinery/door/window/northright,
/obj/structure/fans/tiny,
/turf/open/floor/mineral/titanium/tiled/white,
/area/ship/bridge)
"Y" = (
/obj/machinery/power/smes/shuttle/precharged{
	dir = 4
	},
/obj/structure/window/reinforced{
	dir = 8
	},
/obj/structure/window/reinforced,
/obj/structure/cable{
	icon_state = "0-8"
	},
/turf/open/floor/plating,
/area/ship/bridge)
"Z" = (
/turf/open/floor/mineral/titanium/tiled,
/area/ship/bridge)

(1,1,1) = {"
l
E
E
E
l
"}
(2,1,1) = {"
t
U
k
s
Y
"}
(3,1,1) = {"
p
z
v
L
N
"}
(4,1,1) = {"
V
r
S
Z
i
"}
(5,1,1) = {"
x
H
K
f
x
"}
(6,1,1) = {"
c
r
Z
Z
w
"}
(7,1,1) = {"
b
a
v
v
h
"}
(8,1,1) = {"
e
C
u
C
A
"}
(9,1,1) = {"
g
x
I
x
g
"}
