//MAP CONVERTED BY dmm2tgm.py THIS HEADER COMMENT PREVENTS RECONVERSION, DO NOT REMOVE
"ae" = (
/obj/structure/table/wood/fancy/purple,
/obj/item/storage/backpack/magspear_quiver,
/obj/item/storage/backpack/magspear_quiver,
/turf/open/floor/wood/tile,
/area/ruin/powered{
	name = "\improper Dining Hall"
	})
"aF" = (
/obj/structure/table/wood/fancy,
/obj/item/reagent_containers/food/snacks/fishandchips,
/turf/open/floor/carpet/red/airless,
/area/ruin/powered{
	name = "\improper Dining Hall"
	})
"bE" = (
/obj/structure/window/fulltile,
/obj/structure/grille,
/turf/open/floor/plating,
/area/ruin/powered{
	name = "\improper Dining Hall"
	})
"dd" = (
/obj/effect/turf_decal/siding/wood{
	dir = 9
	},
/turf/open/floor/carpet/red,
/area/ruin/powered{
	name = "\improper Dining Hall"
	})
"ep" = (
/obj/effect/turf_decal/siding/wood{
	dir = 10
	},
/turf/open/floor/carpet/red,
/area/ruin/powered{
	name = "\improper Dining Hall"
	})
"hd" = (
/obj/structure/table/wood/fancy,
/obj/item/reagent_containers/food/snacks/burger/fish,
/turf/open/floor/carpet/red/airless,
/area/ruin/powered{
	name = "\improper Dining Hall"
	})
"hH" = (
/obj/structure/railing{
	dir = 4
	},
/obj/structure/railing{
	dir = 8
	},
/turf/open/floor/iron/stairs,
/area/ruin/powered{
	name = "\improper Dining Hall"
	})
"hK" = (
/obj/effect/turf_decal/siding/wood,
/obj/structure/chair/wood/wings{
	dir = 1
	},
/turf/open/floor/carpet/red,
/area/ruin/powered{
	name = "\improper Dining Hall"
	})
"jD" = (
/obj/machinery/door/airlock/public/glass,
/turf/open/floor/iron/dark/textured_large,
/area/ruin/powered{
	name = "\improper Cold Storage"
	})
"mr" = (
/mob/living/simple_animal/hostile/pirate/melee/beach,
/obj/effect/turf_decal/siding/wood{
	dir = 8
	},
/turf/open/floor/carpet/red,
/area/ruin/powered{
	name = "\improper Dining Hall"
	})
"nv" = (
/obj/machinery/atmospherics/pipe/heat_exchanging/simple{
	dir = 4
	},
/turf/open/floor/iron/kitchen_coldroom/freezerfloor,
/area/ruin/powered{
	name = "\improper Cold Storage"
	})
"oE" = (
/turf/open/floor/wood/tile,
/area/ruin/powered{
	name = "\improper Dining Hall"
	})
"pI" = (
/mob/living/simple_animal/hostile/cat_butcherer{
	atmos_requirements = list("min_oxy" = 0, "max_oxy" = 0, "min_tox" = 0, "max_tox" = 0, "min_co2" = 0, "max_co2" = 0, "min_n2" = 0, "max_n2" = 0);
	desc = "A profession carp butcher, gone mad due to carptoxin exposure. There seems to be something in their pocket...";
	faction = list("hostile", "beach");
	health = 300;
	held_items = held();
	loot = list(/obj/effect/mob_spawn/human/corpse/cat_butcher, /obj/item/guardiancreator/carp);
	maxHealth = 300;
	maxbodytemp = 10000;
	melee_damage_lower = 20;
	melee_damage_upper = 25;
	minbodytemp = 0;
	name = "The Butcher";
	ranged_cooldown_time = 15;
	ranged_message = "fires the speargun at";
	real_name = "The Butcher";
	unique_name = 1
	},
/turf/open/floor/iron/kitchen_coldroom/freezerfloor,
/area/ruin/powered{
	name = "\improper Cold Storage"
	})
"sA" = (
/obj/effect/turf_decal/siding/wood{
	dir = 6
	},
/turf/open/floor/carpet/red,
/area/ruin/powered{
	name = "\improper Dining Hall"
	})
"tV" = (
/mob/living/simple_animal/hostile/pirate/melee/beach,
/obj/effect/turf_decal/siding/wood{
	dir = 4
	},
/turf/open/floor/carpet/red,
/area/ruin/powered{
	name = "\improper Dining Hall"
	})
"tX" = (
/turf/closed/wall,
/area/ruin/powered{
	name = "\improper Cold Storage"
	})
"ut" = (
/turf/closed/wall,
/area/ruin/powered{
	name = "\improper Dining Hall"
	})
"uD" = (
/obj/effect/turf_decal/siding/wood{
	dir = 8
	},
/turf/open/floor/carpet/red,
/area/ruin/powered{
	name = "\improper Dining Hall"
	})
"uZ" = (
/obj/effect/turf_decal/siding/wood{
	dir = 1
	},
/obj/structure/chair/wood/wings,
/turf/open/floor/carpet/red,
/area/ruin/powered{
	name = "\improper Dining Hall"
	})
"vc" = (
/obj/structure/table/wood/fancy,
/obj/item/reagent_containers/food/snacks/meat/slab/human/mutant/squid,
/turf/open/floor/carpet/red/airless,
/area/ruin/powered{
	name = "\improper Dining Hall"
	})
"vL" = (
/obj/structure/kitchenspike,
/obj/machinery/atmospherics/pipe/heat_exchanging/simple{
	dir = 4
	},
/turf/open/floor/iron/kitchen_coldroom/freezerfloor,
/area/ruin/powered{
	name = "\improper Cold Storage"
	})
"wH" = (
/mob/living/simple_animal/hostile/pirate/ranged/beach,
/obj/effect/turf_decal/siding/wood{
	dir = 1
	},
/obj/structure/chair/wood/wings,
/turf/open/floor/carpet/red,
/area/ruin/powered{
	name = "\improper Dining Hall"
	})
"Ch" = (
/obj/structure/table/wood/fancy/purple,
/obj/item/pneumatic_cannon/speargun,
/obj/item/pneumatic_cannon/speargun,
/turf/open/floor/wood/tile,
/area/ruin/powered{
	name = "\improper Dining Hall"
	})
"Ds" = (
/obj/structure/table/wood/fancy,
/obj/item/storage/fancy/cigarettes/cigars/havana,
/turf/open/floor/carpet/red/airless,
/area/ruin/powered{
	name = "\improper Dining Hall"
	})
"DM" = (
/obj/structure/table/wood/fancy,
/obj/item/reagent_containers/food/drinks/soda_cans/cola,
/turf/open/floor/carpet/red/airless,
/area/ruin/powered{
	name = "\improper Dining Hall"
	})
"DO" = (
/obj/structure/table/wood/fancy,
/obj/item/reagent_containers/food/snacks/fishfry,
/turf/open/floor/carpet/red/airless,
/area/ruin/powered{
	name = "\improper Dining Hall"
	})
"Em" = (
/obj/effect/turf_decal/siding/wood{
	dir = 4
	},
/turf/open/floor/carpet/red,
/area/ruin/powered{
	name = "\improper Dining Hall"
	})
"Eq" = (
/obj/structure/railing{
	dir = 5
	},
/turf/open/floor/iron/large,
/area/ruin/powered{
	name = "\improper Dining Hall"
	})
"FG" = (
/turf/template_noop,
/area/template_noop)
"FK" = (
/obj/machinery/light/dim,
/turf/open/floor/wood/tile,
/area/ruin/powered{
	name = "\improper Dining Hall"
	})
"Iv" = (
/obj/structure/table/wood/fancy/purple,
/obj/item/toy/plush/carpplushie/dehy_carp,
/obj/item/toy/plush/carpplushie/dehy_carp,
/obj/item/toy/plush/carpplushie/dehy_carp,
/obj/item/grenade/spawnergrenade/spesscarp,
/turf/open/floor/wood/tile,
/area/ruin/powered{
	name = "\improper Dining Hall"
	})
"Ko" = (
/obj/structure/railing{
	dir = 4
	},
/turf/open/floor/iron/stairs,
/area/ruin/powered{
	name = "\improper Dining Hall"
	})
"Kq" = (
/obj/machinery/light/dim,
/turf/open/floor/iron/kitchen_coldroom/freezerfloor,
/area/ruin/powered{
	name = "\improper Cold Storage"
	})
"KY" = (
/obj/structure/table/wood/fancy,
/obj/item/reagent_containers/food/snacks/cubancarp,
/turf/open/floor/carpet/red/airless,
/area/ruin/powered{
	name = "\improper Dining Hall"
	})
"Ly" = (
/obj/machinery/door/airlock/public/glass,
/turf/open/floor/iron/dark/textured_large,
/area/ruin/powered{
	name = "\improper Dining Hall"
	})
"Mn" = (
/obj/structure/sink,
/turf/closed/wall,
/area/ruin/powered{
	name = "\improper Cold Storage"
	})
"Ok" = (
/obj/machinery/atmospherics/components/unary/thermomachine/freezer/on/coldroom,
/turf/open/floor/iron/kitchen_coldroom/freezerfloor,
/area/ruin/powered{
	name = "\improper Cold Storage"
	})
"Os" = (
/obj/effect/turf_decal/siding/wood{
	dir = 5
	},
/turf/open/floor/carpet/red,
/area/ruin/powered{
	name = "\improper Dining Hall"
	})
"OE" = (
/obj/structure/table/rolling,
/obj/item/kitchen/knife/butcher,
/turf/open/floor/iron/kitchen_coldroom/freezerfloor,
/area/ruin/powered{
	name = "\improper Cold Storage"
	})
"PB" = (
/obj/structure/kitchenspike,
/turf/open/floor/iron/kitchen_coldroom/freezerfloor,
/area/ruin/powered{
	name = "\improper Cold Storage"
	})
"Qi" = (
/obj/structure/closet/secure_closet/freezer/fridge,
/obj/item/reagent_containers/food/snacks/carpmeat,
/obj/item/reagent_containers/food/snacks/carpmeat,
/obj/item/reagent_containers/food/snacks/carpmeat,
/obj/item/reagent_containers/food/snacks/carpmeat,
/obj/item/reagent_containers/food/snacks/carpmeat,
/turf/open/floor/iron/kitchen_coldroom/freezerfloor,
/area/ruin/powered{
	name = "\improper Cold Storage"
	})
"QO" = (
/turf/open/floor/iron/kitchen_coldroom/freezerfloor,
/area/ruin/powered{
	name = "\improper Cold Storage"
	})
"Ta" = (
/obj/structure/table/rolling,
/obj/machinery/microwave,
/turf/open/floor/iron/kitchen_coldroom/freezerfloor,
/area/ruin/powered{
	name = "\improper Cold Storage"
	})
"WT" = (
/obj/structure/chair/wood/wings,
/obj/item/nullrod/carp,
/turf/open/floor/wood/tile,
/area/ruin/powered{
	name = "\improper Dining Hall"
	})
"Xp" = (
/obj/structure/table/rolling,
/obj/item/clothing/suit/space/hardsuit/carp,
/turf/open/floor/iron/kitchen_coldroom/freezerfloor,
/area/ruin/powered{
	name = "\improper Cold Storage"
	})
"Xt" = (
/obj/machinery/deepfryer,
/turf/open/floor/iron/kitchen_coldroom/freezerfloor,
/area/ruin/powered{
	name = "\improper Cold Storage"
	})
"YJ" = (
/obj/structure/closet/crate/freezer,
/obj/item/reagent_containers/food/snacks/carpmeat,
/obj/item/reagent_containers/food/snacks/carpmeat,
/obj/item/reagent_containers/food/snacks/carpmeat,
/obj/item/reagent_containers/food/snacks/carpmeat,
/obj/item/reagent_containers/food/snacks/carpmeat,
/turf/open/floor/iron/kitchen_coldroom/freezerfloor,
/area/ruin/powered{
	name = "\improper Cold Storage"
	})
"ZG" = (
/obj/machinery/atmospherics/pipe/heat_exchanging/junction,
/turf/open/floor/iron/kitchen_coldroom/freezerfloor,
/area/ruin/powered{
	name = "\improper Cold Storage"
	})

(1,1,1) = {"
FG
FG
FG
FG
FG
FG
FG
FG
FG
FG
FG
FG
FG
FG
"}
(2,1,1) = {"
FG
FG
FG
ut
ut
ut
ut
ut
ut
FG
FG
FG
FG
FG
"}
(3,1,1) = {"
FG
FG
bE
bE
Iv
ae
Ch
FK
tX
tX
tX
tX
tX
tX
"}
(4,1,1) = {"
FG
bE
bE
oE
oE
oE
oE
oE
tX
Ok
ZG
QO
QO
tX
"}
(5,1,1) = {"
FG
bE
oE
oE
oE
oE
oE
oE
jD
QO
QO
PB
Kq
tX
"}
(6,1,1) = {"
FG
bE
oE
dd
mr
uD
ep
oE
jD
QO
QO
nv
QO
tX
"}
(7,1,1) = {"
FG
bE
oE
uZ
hd
vc
hK
FK
Mn
QO
QO
vL
QO
tX
"}
(8,1,1) = {"
FG
bE
oE
wH
aF
Ds
hK
oE
tX
OE
pI
QO
QO
tX
"}
(9,1,1) = {"
FG
bE
oE
uZ
DM
DM
hK
oE
tX
Qi
QO
vL
QO
tX
"}
(10,1,1) = {"
FG
bE
oE
uZ
KY
DO
hK
FK
tX
Ta
QO
QO
QO
tX
"}
(11,1,1) = {"
FG
bE
oE
Os
tV
Em
sA
oE
tX
Xp
QO
vL
QO
tX
"}
(12,1,1) = {"
FG
bE
oE
oE
WT
oE
oE
oE
tX
Xt
QO
nv
Kq
tX
"}
(13,1,1) = {"
FG
bE
bE
oE
oE
oE
oE
oE
tX
YJ
QO
QO
QO
tX
"}
(14,1,1) = {"
FG
FG
bE
bE
oE
oE
oE
FK
tX
tX
tX
tX
tX
tX
"}
(15,1,1) = {"
FG
FG
FG
ut
ut
Ly
ut
ut
ut
FG
FG
FG
FG
FG
"}
(16,1,1) = {"
FG
FG
FG
FG
FG
Eq
Ko
Ko
Ko
hH
FG
FG
FG
FG
"}
(17,1,1) = {"
FG
FG
FG
FG
FG
FG
FG
FG
FG
FG
FG
FG
FG
FG
"}
(18,1,1) = {"
FG
FG
FG
FG
FG
FG
FG
FG
FG
FG
FG
FG
FG
FG
"}
