//MAP CONVERTED BY dmm2tgm.py THIS HEADER COMMENT PREVENTS RECONVERSION, DO NOT REMOVE
"aD" = (
/obj/structure/table/wood/reinforced,
/turf/open/floor/wood/yew,
/area/ruin/powered)
"aG" = (
/obj/structure/chair,
/obj/effect/mob_spawn/human/corpse/solgov/infantry,
/obj/effect/decal/cleanable/blood,
/obj/item/restraints/handcuffs,
/turf/open/floor/wood/mahogany,
/area/ruin/powered)
"aN" = (
/obj/machinery/chem_dispenser,
/obj/machinery/light,
/turf/open/floor/plastic,
/area/ruin/powered)
"aR" = (
/obj/machinery/door/airlock{
	name = "Lounge"
	},
/turf/open/floor/iron/dark/smooth_half,
/area/ruin/powered)
"bn" = (
/mob/living/simple_animal/hostile/russian,
/turf/open/floor/mineral/titanium/tiled,
/area/ruin/powered)
"cM" = (
/obj/structure/chair/sofa/right,
/turf/open/floor/wood/yew,
/area/ruin/powered)
"dd" = (
/obj/effect/decal/hammerandsickle,
/turf/open/floor/mineral/titanium/tiled,
/area/ruin/powered)
"df" = (
/mob/living/simple_animal/hostile/russian/ranged/trooper,
/turf/open/floor/wood/yew,
/area/ruin/powered)
"ds" = (
/mob/living/simple_animal/hostile/russian/ranged/trooper,
/turf/open/floor/wood/mahogany,
/area/ruin/powered)
"dw" = (
/obj/item/clothing/mask/cigarette/rollie/cannabis,
/turf/open/floor/wood/yew,
/area/ruin/powered)
"dG" = (
/obj/machinery/light,
/obj/effect/turf_decal/corner/blue/diagonal,
/turf/open/floor/iron/white,
/area/ruin/powered)
"ed" = (
/obj/structure/chair/sofa/left{
	dir = 1
	},
/turf/open/floor/wood/yew,
/area/ruin/powered)
"fv" = (
/obj/machinery/light,
/turf/open/floor/mineral/titanium/tiled,
/area/ruin/powered)
"fL" = (
/obj/item/surgicaldrill,
/obj/effect/decal/cleanable/blood/splatter,
/turf/open/floor/carpet/red_gold,
/area/ruin/powered)
"ga" = (
/obj/item/reagent_containers/syringe/contraband/space_drugs,
/turf/open/floor/plastic,
/area/ruin/powered)
"gd" = (
/obj/machinery/door/airlock/public/glass{
	name = "Drug Production"
	},
/turf/open/floor/iron/dark/smooth_half{
	dir = 1
	},
/area/ruin/powered)
"go" = (
/obj/structure/table/wood/reinforced,
/obj/item/reagent_containers/food/drinks/trophy/gold_cup,
/turf/open/floor/wood/yew,
/area/ruin/powered)
"gE" = (
/obj/machinery/seed_extractor,
/turf/open/floor/mineral/titanium/white,
/area/ruin/powered)
"he" = (
/obj/structure/table/wood/reinforced,
/obj/item/kitchen/knife/combat,
/turf/open/floor/wood/yew,
/area/ruin/powered)
"hh" = (
/obj/machinery/computer{
	dir = 1
	},
/turf/open/floor/wood/mahogany,
/area/ruin/powered)
"hm" = (
/obj/item/reagent_containers/pill/floorpill,
/turf/open/floor/wood/mahogany,
/area/ruin/powered)
"ho" = (
/obj/structure/table/wood/reinforced,
/obj/item/clothing/mask/cigarette/rollie/cannabis,
/obj/effect/turf_decal/siding/thinplating/dark/corner{
	dir = 8
	},
/obj/item/lighter,
/obj/item/reagent_containers/syringe/contraband/space_drugs,
/obj/item/reagent_containers/pill/floorpill,
/turf/open/floor/wood/yew,
/area/ruin/powered)
"ie" = (
/turf/open/floor/wood/mahogany,
/area/ruin/powered)
"jD" = (
/obj/item/reagent_containers/syringe/contraband/space_drugs,
/obj/item/reagent_containers/pill/floorpill,
/turf/open/floor/plastic,
/area/ruin/powered)
"kc" = (
/obj/structure/table/glass,
/obj/item/storage/box/syringes,
/turf/open/floor/iron/white/small,
/area/ruin/powered)
"kf" = (
/obj/machinery/door/airlock{
	name = "Smoking Room"
	},
/turf/open/floor/iron/dark/smooth_half,
/area/ruin/powered)
"kQ" = (
/obj/structure/table/wood/reinforced,
/obj/item/stack/medical/bruise_pack,
/turf/open/floor/wood/yew,
/area/ruin/powered)
"kR" = (
/obj/machinery/door/airlock/public/glass{
	name = "Drug Production"
	},
/turf/open/floor/iron/dark/smooth_half,
/area/ruin/powered)
"kW" = (
/obj/machinery/computer{
	dir = 8
	},
/turf/open/floor/wood/mahogany,
/area/ruin/powered)
"mf" = (
/mob/living/simple_animal/hostile/russian,
/turf/open/floor/carpet/red,
/area/ruin/powered)
"mK" = (
/obj/structure/chair/sofa/right{
	dir = 1
	},
/turf/open/floor/carpet/red,
/area/ruin/powered)
"mW" = (
/obj/structure/table/glass,
/obj/item/storage/box/beakers,
/turf/open/floor/iron/white/small,
/area/ruin/powered)
"nh" = (
/turf/open/floor/mineral/titanium/white,
/area/ruin/powered)
"nz" = (
/mob/living/simple_animal/hostile/russian,
/turf/open/floor/carpet/red_gold,
/area/ruin/powered)
"nC" = (
/obj/machinery/light,
/turf/open/floor/carpet/red,
/area/ruin/powered)
"nS" = (
/obj/effect/turf_decal/corner/blue/diagonal,
/obj/machinery/smartfridge/organ,
/turf/open/floor/iron/white,
/area/ruin/powered)
"pi" = (
/obj/structure/chair/office/light,
/turf/open/floor/plastic,
/area/ruin/powered)
"pm" = (
/obj/structure/chair/sofa/right{
	dir = 1
	},
/obj/effect/turf_decal/siding/thinplating/dark{
	dir = 4
	},
/turf/open/floor/wood/yew,
/area/ruin/powered)
"pq" = (
/obj/item/flashlight/lamp/green,
/obj/structure/table/wood/reinforced,
/turf/open/floor/wood/yew,
/area/ruin/powered)
"pG" = (
/obj/item/reagent_containers/pill/floorpill,
/turf/open/floor/plastic,
/area/ruin/powered)
"pY" = (
/obj/effect/turf_decal/siding/thinplating/dark,
/turf/open/floor/carpet/black,
/area/ruin/powered)
"qg" = (
/obj/machinery/hydroponics,
/obj/item/seeds/cannabis/ultimate,
/turf/open/floor/mineral/titanium/white,
/area/ruin/powered)
"qC" = (
/obj/item/reagent_containers/syringe/contraband/space_drugs,
/turf/open/floor/carpet/red,
/area/ruin/powered)
"qD" = (
/obj/structure/chair/sofa/corner{
	dir = 1
	},
/obj/machinery/light,
/mob/living/simple_animal/hostile/russian,
/turf/open/floor/carpet/red,
/area/ruin/powered)
"rb" = (
/obj/structure/table/glass,
/obj/item/research_notes/loot/medium,
/turf/open/floor/iron/white/small,
/area/ruin/powered)
"rN" = (
/obj/item/kirbyplants,
/turf/open/floor/wood/yew,
/area/ruin/powered)
"sd" = (
/mob/living/simple_animal/hostile/russian/ranged/trooper,
/turf/open/floor/iron/white/small,
/area/ruin/powered)
"se" = (
/obj/item/kirbyplants,
/turf/open/floor/wood/mahogany,
/area/ruin/powered)
"sn" = (
/turf/open/floor/wood/yew,
/area/ruin/powered)
"sP" = (
/mob/living/simple_animal/hostile/russian/ranged/officer,
/turf/open/floor/carpet/red_gold,
/area/ruin/powered)
"uC" = (
/obj/item/lighter,
/turf/open/floor/carpet/red_gold,
/area/ruin/powered)
"ve" = (
/obj/item/kirbyplants,
/turf/open/floor/iron/white/small,
/area/ruin/powered)
"vf" = (
/obj/item/stack/sheet/mineral/diamond/five,
/obj/structure/table/wood/reinforced,
/obj/item/lighter,
/obj/item/reagent_containers/syringe/contraband/space_drugs,
/turf/open/floor/wood/yew,
/area/ruin/powered)
"vY" = (
/obj/machinery/light,
/obj/machinery/jukebox,
/turf/open/floor/wood/yew,
/area/ruin/powered)
"wT" = (
/obj/item/clothing/mask/cigarette/rollie/cannabis,
/turf/open/floor/carpet/red,
/area/ruin/powered)
"xr" = (
/obj/structure/chair/office/light,
/mob/living/simple_animal/hostile/russian,
/turf/open/floor/mineral/titanium/white,
/area/ruin/powered)
"xL" = (
/obj/structure/chair/sofa,
/turf/open/floor/carpet/red,
/area/ruin/powered)
"yf" = (
/obj/structure/table/wood/fancy/red_gold,
/obj/item/folder/red,
/turf/open/floor/wood/mahogany,
/area/ruin/powered)
"yA" = (
/obj/machinery/light,
/turf/open/floor/mineral/titanium/white,
/area/ruin/powered)
"yE" = (
/obj/machinery/chem_master,
/turf/open/floor/plastic,
/area/ruin/powered)
"yG" = (
/obj/structure/chair/sofa/right,
/obj/item/reagent_containers/pill/floorpill,
/turf/open/floor/carpet/red,
/area/ruin/powered)
"zd" = (
/obj/structure/table/wood/fancy/red_gold,
/obj/item/reagent_containers/pill/floorpill,
/turf/open/floor/carpet/red_gold,
/area/ruin/powered)
"zj" = (
/obj/structure/table/wood/reinforced,
/obj/item/crusher_trophy/elder_tentacle,
/obj/effect/turf_decal/siding/thinplating/dark/corner,
/turf/open/floor/wood/yew,
/area/ruin/powered)
"zJ" = (
/obj/structure/chair/sofa/left{
	dir = 1
	},
/obj/effect/turf_decal/siding/thinplating/dark{
	dir = 8
	},
/turf/open/floor/wood/yew,
/area/ruin/powered)
"Ad" = (
/obj/structure/table/wood/fancy/red_gold,
/obj/item/storage/pill_bottle/floorpill/full,
/obj/item/reagent_containers/syringe/contraband/space_drugs,
/turf/open/floor/carpet/red_gold,
/area/ruin/powered)
"AN" = (
/obj/structure/table/wood/fancy/red_gold,
/obj/item/research_notes/loot/small,
/obj/item/research_notes/loot/small,
/turf/open/floor/wood/mahogany,
/area/ruin/powered)
"AP" = (
/obj/machinery/door/airlock/medical{
	name = "Aid Post"
	},
/turf/open/floor/iron/dark/smooth_half,
/area/ruin/powered)
"Cm" = (
/obj/item/gun/ballistic/revolver/golden,
/obj/item/ammo_casing/a357,
/obj/item/ammo_casing/a357,
/obj/item/ammo_casing/a357,
/obj/item/ammo_casing/a357,
/obj/item/ammo_casing/a357,
/obj/item/ammo_casing/a357,
/obj/structure/table/wood/reinforced,
/turf/open/floor/wood/yew,
/area/ruin/powered)
"Cs" = (
/obj/structure/table/wood/fancy/red_gold,
/obj/item/clothing/mask/cigarette/rollie/cannabis,
/turf/open/floor/wood/mahogany,
/area/ruin/powered)
"Cz" = (
/obj/structure/table/wood/fancy/red_gold,
/obj/item/reagent_containers/pill/stimulant,
/obj/item/lighter,
/turf/open/floor/carpet/red_gold,
/area/ruin/powered)
"CI" = (
/obj/item/kirbyplants,
/turf/open/floor/carpet/red,
/area/ruin/powered)
"CO" = (
/obj/item/kirbyplants,
/turf/open/floor/plastic,
/area/ruin/powered)
"CP" = (
/obj/effect/turf_decal/corner/blue/diagonal,
/mob/living/simple_animal/hostile/russian,
/turf/open/floor/iron/white,
/area/ruin/powered)
"CX" = (
/obj/item/storage/fancy/rollingpapers{
	pixel_y = 7;
	pixel_x = 5
	},
/obj/item/clothing/mask/cigarette/rollie/cannabis,
/obj/item/clothing/mask/cigarette/rollie/cannabis{
	pixel_y = 4;
	pixel_x = -2
	},
/obj/structure/table/wood/reinforced,
/obj/item/stack/spacecash/c1000{
	pixel_y = 11;
	pixel_x = -4
	},
/obj/item/lighter/greyscale{
	pixel_y = -4;
	pixel_x = 9
	},
/turf/open/floor/carpet/red,
/area/ruin/powered)
"Df" = (
/obj/structure/chair/sofa/left,
/turf/open/floor/carpet/red,
/area/ruin/powered)
"Dw" = (
/obj/effect/turf_decal/corner/blue/diagonal,
/obj/item/clothing/mask/cigarette/rollie/cannabis,
/obj/item/reagent_containers/syringe/contraband/space_drugs,
/turf/open/floor/iron/white,
/area/ruin/powered)
"Dz" = (
/mob/living/simple_animal/hostile/bear/russian,
/turf/open/floor/wood/yew,
/area/ruin/powered)
"Ea" = (
/obj/effect/turf_decal/corner/blue/diagonal,
/obj/structure/table/optable,
/turf/open/floor/iron/white,
/area/ruin/powered)
"Er" = (
/obj/structure/table/glass,
/obj/item/stack/medical/suture,
/turf/open/floor/iron/white/small,
/area/ruin/powered)
"Fr" = (
/mob/living/simple_animal/hostile/russian/ranged/officer,
/turf/open/floor/plastic,
/area/ruin/powered)
"FB" = (
/obj/machinery/door/airlock{
	name = "Lounge"
	},
/turf/open/floor/iron/dark/smooth_half{
	dir = 1
	},
/area/ruin/powered)
"FK" = (
/obj/structure/closet/crate/freezer/blood,
/turf/open/floor/iron/white/small,
/area/ruin/powered)
"FT" = (
/obj/effect/turf_decal/siding/thinplating/dark{
	dir = 8
	},
/turf/open/floor/carpet/red,
/area/ruin/powered)
"Gq" = (
/obj/item/book/manual/wiki/chemistry,
/obj/structure/table/reinforced,
/turf/open/floor/plastic,
/area/ruin/powered)
"Gv" = (
/obj/machinery/vending/hydroseeds,
/turf/open/floor/mineral/titanium/white,
/area/ruin/powered)
"GK" = (
/turf/closed/wall/r_wall,
/area/ruin/powered)
"GQ" = (
/obj/structure/chair/comfy{
	dir = 8;
	color = "#292B2D"
	},
/turf/open/floor/wood/mahogany,
/area/ruin/powered)
"Ha" = (
/obj/machinery/chem_dispenser/drinks{
	dir = 4;
	pixel_y = -1
	},
/obj/structure/table/wood/reinforced,
/obj/item/reagent_containers/food/drinks/drinkingglass,
/obj/item/reagent_containers/food/drinks/drinkingglass,
/obj/item/reagent_containers/food/drinks/drinkingglass,
/turf/open/floor/wood/yew,
/area/ruin/powered)
"HH" = (
/obj/machinery/light,
/obj/structure/reagent_dispensers/watertank,
/turf/open/floor/mineral/titanium/white,
/area/ruin/powered)
"Iv" = (
/obj/machinery/door/airlock/medical{
	name = "Aid Post"
	},
/turf/open/floor/iron/dark/smooth_half{
	dir = 1
	},
/area/ruin/powered)
"Iw" = (
/obj/machinery/light,
/obj/structure/closet/secure_closet/hydroponics,
/turf/open/floor/mineral/titanium/white,
/area/ruin/powered)
"JH" = (
/obj/machinery/iv_drip,
/turf/open/floor/iron/white/small,
/area/ruin/powered)
"JQ" = (
/obj/machinery/chem_heater,
/turf/open/floor/plastic,
/area/ruin/powered)
"Kl" = (
/mob/living/simple_animal/hostile/russian,
/turf/open/floor/iron/white/small,
/area/ruin/powered)
"Kp" = (
/obj/machinery/computer{
	dir = 4
	},
/turf/open/floor/wood/mahogany,
/area/ruin/powered)
"KY" = (
/obj/structure/table/reinforced,
/obj/item/storage/box/beakers,
/turf/open/floor/plastic,
/area/ruin/powered)
"Le" = (
/obj/structure/table/wood/fancy/red_gold,
/obj/item/lighter,
/turf/open/floor/wood/mahogany,
/area/ruin/powered)
"Lu" = (
/obj/effect/turf_decal/siding/thinplating/dark{
	dir = 4
	},
/turf/open/floor/carpet/red,
/area/ruin/powered)
"Mn" = (
/obj/machinery/light,
/obj/item/kirbyplants,
/turf/open/floor/iron/white/small,
/area/ruin/powered)
"MB" = (
/obj/machinery/light,
/turf/open/floor/wood/yew,
/area/ruin/powered)
"MI" = (
/obj/structure/chair/sofa/left,
/obj/item/reagent_containers/pill/floorpill,
/turf/open/floor/wood/yew,
/area/ruin/powered)
"Nh" = (
/obj/effect/turf_decal/siding/thinplating/dark{
	dir = 8
	},
/turf/open/floor/wood/yew,
/area/ruin/powered)
"NM" = (
/obj/machinery/light,
/obj/structure/table/glass,
/obj/item/stack/medical/gauze,
/turf/open/floor/iron/white/small,
/area/ruin/powered)
"NY" = (
/obj/item/reagent_containers/pill/happy,
/turf/open/floor/carpet/red_gold,
/area/ruin/powered)
"NZ" = (
/obj/structure/table/reinforced,
/obj/item/research_notes/loot/big,
/obj/item/reagent_containers/syringe/contraband/space_drugs,
/obj/item/reagent_containers/pill/floorpill,
/obj/item/storage/pill_bottle/floorpill/full,
/turf/open/floor/plastic,
/area/ruin/powered)
"Oa" = (
/obj/item/stack/spacecash/c1000,
/obj/structure/chair/sofa,
/obj/item/clothing/mask/cigarette/rollie/cannabis,
/turf/open/floor/wood/yew,
/area/ruin/powered)
"Od" = (
/obj/structure/table/wood/reinforced,
/obj/item/reagent_containers/syringe/contraband/space_drugs,
/obj/item/reagent_containers/pill/floorpill,
/turf/open/floor/wood/yew,
/area/ruin/powered)
"OV" = (
/obj/item/clothing/mask/cigarette/rollie/cannabis,
/turf/open/floor/carpet/red_gold,
/area/ruin/powered)
"OY" = (
/obj/effect/turf_decal/siding/thinplating/dark{
	dir = 4
	},
/turf/open/floor/wood/yew,
/area/ruin/powered)
"Pk" = (
/obj/item/reagent_containers/pill/floorpill,
/turf/open/floor/carpet/red,
/area/ruin/powered)
"Pq" = (
/obj/machinery/microwave{
	pixel_y = 6;
	pixel_x = -1
	},
/obj/structure/table/wood/reinforced,
/turf/open/floor/wood/yew,
/area/ruin/powered)
"Px" = (
/turf/open/floor/carpet/red,
/area/ruin/powered)
"QN" = (
/turf/open/floor/plastic,
/area/ruin/powered)
"QY" = (
/obj/structure/bed,
/obj/item/bedsheet/medical,
/turf/open/floor/iron/white/small,
/area/ruin/powered)
"Ri" = (
/obj/machinery/light,
/obj/item/kirbyplants,
/turf/open/floor/wood/yew,
/area/ruin/powered)
"RJ" = (
/obj/effect/spawner/structure/window/plasma/reinforced,
/turf/open/floor/plating,
/area/ruin/powered)
"RS" = (
/obj/machinery/door/airlock/command/glass{
	name = "Command Lounge"
	},
/turf/open/floor/iron/dark/smooth_half{
	dir = 1
	},
/area/ruin/powered)
"Sa" = (
/obj/structure/table/glass,
/obj/item/stack/spacecash/c1000,
/obj/item/stack/spacecash/c1000,
/obj/item/stack/spacecash/c200,
/obj/item/stack/medical/suture,
/obj/effect/turf_decal/corner/blue/diagonal,
/turf/open/floor/iron/white,
/area/ruin/powered)
"Sb" = (
/obj/structure/chair/sofa/right,
/obj/item/clothing/mask/cigarette/rollie/cannabis,
/turf/open/floor/carpet/red,
/area/ruin/powered)
"SB" = (
/obj/item/reagent_containers/pill/stimulant,
/turf/open/floor/carpet/red,
/area/ruin/powered)
"SI" = (
/obj/effect/turf_decal/corner/blue/diagonal,
/obj/item/kirbyplants,
/turf/open/floor/iron/white,
/area/ruin/powered)
"SL" = (
/obj/structure/chair/sofa/left{
	dir = 4
	},
/turf/open/floor/carpet/red,
/area/ruin/powered)
"SN" = (
/obj/structure/chair/comfy{
	color = "#292B2D"
	},
/turf/open/floor/wood/mahogany,
/area/ruin/powered)
"Td" = (
/obj/structure/chair/comfy{
	color = "#292B2D";
	dir = 4
	},
/turf/open/floor/wood/mahogany,
/area/ruin/powered)
"TE" = (
/obj/item/storage/pill_bottle/floorpill/full,
/turf/open/floor/plastic,
/area/ruin/powered)
"TH" = (
/obj/machinery/hydroponics,
/obj/item/seeds/cannabis,
/turf/open/floor/mineral/titanium/white,
/area/ruin/powered)
"TO" = (
/obj/machinery/door/airlock{
	name = "Russian Outpost 28"
	},
/turf/open/floor/iron/dark/smooth_half,
/area/ruin/powered)
"TP" = (
/turf/open/floor/iron/white/small,
/area/ruin/powered)
"Ui" = (
/obj/structure/table/wood/fancy/red_gold,
/obj/item/flashlight/lamp/green,
/turf/open/floor/wood/mahogany,
/area/ruin/powered)
"Uj" = (
/turf/open/floor/carpet/red_gold,
/area/ruin/powered)
"Vb" = (
/turf/template_noop,
/area/template_noop)
"VO" = (
/obj/machinery/light,
/obj/structure/table/wood/reinforced,
/obj/item/flashlight/lamp/green,
/turf/open/floor/wood/yew,
/area/ruin/powered)
"Wu" = (
/obj/effect/turf_decal/corner/blue/diagonal,
/turf/open/floor/iron/white,
/area/ruin/powered)
"Wx" = (
/obj/machinery/hydroponics,
/obj/item/seeds/cannabis/rainbow,
/turf/open/floor/mineral/titanium/white,
/area/ruin/powered)
"WS" = (
/obj/item/reagent_containers/syringe/contraband/space_drugs,
/turf/open/floor/carpet/red_gold,
/area/ruin/powered)
"WU" = (
/obj/structure/table/wood/fancy/red_gold,
/obj/item/storage/pill_bottle/floorpill/full,
/turf/open/floor/carpet/red_gold,
/area/ruin/powered)
"Xs" = (
/obj/item/reagent_containers/pill/floorpill,
/turf/open/floor/carpet/red_gold,
/area/ruin/powered)
"XC" = (
/obj/machinery/hydroponics,
/obj/item/seeds/cannabis/death,
/turf/open/floor/mineral/titanium/white,
/area/ruin/powered)
"XE" = (
/obj/structure/table/wood/reinforced,
/obj/item/storage/toolbox/emergency/old,
/turf/open/floor/wood/yew,
/area/ruin/powered)
"XK" = (
/obj/structure/table/reinforced,
/obj/machinery/plantgenes/seedvault{
	pixel_y = 7
	},
/turf/open/floor/plastic,
/area/ruin/powered)
"XZ" = (
/obj/structure/chair/sofa/right{
	dir = 1
	},
/turf/open/floor/wood/yew,
/area/ruin/powered)
"YD" = (
/obj/structure/table/wood/fancy/red_gold,
/obj/item/gun/ballistic/automatic/pistol/commander,
/obj/item/clothing/mask/cigarette/rollie/cannabis,
/turf/open/floor/carpet/red_gold,
/area/ruin/powered)
"YJ" = (
/obj/machinery/light,
/obj/effect/turf_decal/corner/blue/diagonal,
/obj/machinery/computer/operating{
	dir = 1
	},
/turf/open/floor/iron/white,
/area/ruin/powered)
"YV" = (
/obj/machinery/hydroponics,
/obj/item/seeds/cannabis/white,
/turf/open/floor/mineral/titanium/white,
/area/ruin/powered)
"Zb" = (
/obj/structure/table/wood/reinforced,
/obj/item/lighter,
/turf/open/floor/wood/yew,
/area/ruin/powered)
"Zo" = (
/obj/item/reagent_containers/pill/happy,
/obj/structure/table/wood/fancy/red_gold,
/turf/open/floor/carpet/red_gold,
/area/ruin/powered)
"Zz" = (
/obj/structure/table/wood/reinforced,
/obj/item/flashlight/lamp/green,
/turf/open/floor/wood/yew,
/area/ruin/powered)
"ZG" = (
/turf/open/floor/mineral/titanium/tiled,
/area/ruin/powered)
"ZH" = (
/obj/item/storage/box/donkpockets,
/obj/structure/table/wood/reinforced,
/obj/item/reagent_containers/syringe/contraband/space_drugs,
/turf/open/floor/wood/yew,
/area/ruin/powered)

(1,1,1) = {"
GK
GK
GK
GK
GK
GK
Vb
Vb
Vb
Vb
Vb
Vb
Vb
Vb
Vb
Vb
Vb
Vb
Vb
Vb
Vb
Vb
"}
(2,1,1) = {"
GK
rN
Ha
ZH
Pq
GK
GK
GK
GK
GK
Vb
Vb
Vb
Vb
Vb
Vb
Vb
Vb
Vb
Vb
Vb
Vb
"}
(3,1,1) = {"
GK
cM
Px
Px
MB
GK
Cm
SL
qD
GK
Vb
Vb
Vb
Vb
Vb
Vb
Vb
Vb
Vb
Vb
Vb
Vb
"}
(4,1,1) = {"
GK
Oa
Px
Px
df
GK
dw
Pk
mK
GK
Vb
Vb
Vb
Vb
Vb
Vb
Vb
Vb
Vb
Vb
Vb
Vb
"}
(5,1,1) = {"
GK
MI
Px
Px
sn
aR
sn
Dz
vf
GK
Vb
Vb
Vb
Vb
Vb
Vb
Vb
Vb
Vb
Vb
Vb
Vb
"}
(6,1,1) = {"
GK
pq
dw
sn
Ri
GK
rN
sn
vY
GK
Vb
Vb
Vb
Vb
Vb
Vb
Vb
Vb
Vb
Vb
Vb
Vb
"}
(7,1,1) = {"
GK
GK
GK
FB
GK
GK
GK
FB
GK
GK
GK
GK
GK
GK
GK
GK
GK
Vb
Vb
Vb
Vb
Vb
"}
(8,1,1) = {"
Vb
GK
rN
sn
rN
GK
rN
sn
sn
sn
sn
sn
Ri
GK
Zb
Od
GK
GK
GK
GK
GK
GK
"}
(9,1,1) = {"
Vb
GK
sn
Px
sn
RJ
sn
Px
Px
Px
Px
Px
sn
kf
sn
MB
GK
CO
pG
ga
yE
GK
"}
(10,1,1) = {"
GK
GK
sn
Px
rN
GK
rN
sn
sn
sn
sn
sn
Ri
GK
sn
sn
GK
NZ
Fr
pi
aN
GK
"}
(11,1,1) = {"
GK
XE
sn
Px
VO
GK
GK
GK
RJ
RS
RJ
GK
GK
GK
CI
Px
GK
XK
jD
TE
JQ
GK
"}
(12,1,1) = {"
GK
go
sn
mf
ed
GK
se
ds
ie
ie
yf
Kp
Ui
GK
Sb
Px
GK
KY
QN
ga
Gq
GK
"}
(13,1,1) = {"
GK
zj
OY
Lu
pm
GK
ie
NY
uC
sP
Xs
GQ
AN
RJ
xL
nC
GK
RJ
gd
RJ
RJ
GK
"}
(14,1,1) = {"
GK
pY
ZG
ZG
fv
GK
ie
fL
YD
zd
WS
ie
hh
RJ
Df
qC
RJ
Gv
nh
nh
Iw
GK
"}
(15,1,1) = {"
TO
pY
bn
dd
ZG
GK
aG
Xs
Zo
WU
Xs
SN
hh
RJ
CX
wT
kR
nh
nh
xr
gE
GK
"}
(16,1,1) = {"
GK
pY
ZG
ZG
fv
GK
ie
Uj
Ad
Cz
OV
ie
hh
RJ
yG
SB
RJ
nh
nh
nh
HH
GK
"}
(17,1,1) = {"
GK
ho
Nh
FT
zJ
GK
hm
nz
Uj
Uj
Uj
Td
Cs
RJ
xL
nC
GK
nh
TH
nh
XC
GK
"}
(18,1,1) = {"
GK
kQ
sn
Px
XZ
GK
se
ie
hm
ie
Ui
kW
Le
GK
Df
Px
GK
nh
nh
nh
nh
GK
"}
(19,1,1) = {"
GK
he
sn
Px
VO
GK
GK
GK
RJ
RS
RJ
GK
GK
GK
CI
wT
GK
nh
Wx
nh
qg
GK
"}
(20,1,1) = {"
GK
GK
sn
Px
rN
GK
rN
sn
sn
sn
dw
sn
Ri
GK
sn
sn
GK
nh
nh
nh
yA
GK
"}
(21,1,1) = {"
Vb
GK
sn
Px
sn
RJ
sn
Px
Px
Px
Px
Px
sn
kf
sn
MB
GK
nh
YV
nh
TH
GK
"}
(22,1,1) = {"
Vb
GK
rN
sn
rN
GK
rN
sn
sn
sn
sn
sn
Ri
GK
Zz
aD
GK
GK
GK
GK
GK
GK
"}
(23,1,1) = {"
GK
GK
GK
Iv
GK
GK
GK
Iv
GK
GK
GK
GK
GK
GK
GK
GK
GK
Vb
Vb
Vb
Vb
Vb
"}
(24,1,1) = {"
GK
mW
sd
TP
Mn
GK
SI
Wu
YJ
GK
Vb
Vb
Vb
Vb
Vb
Vb
Vb
Vb
Vb
Vb
Vb
Vb
"}
(25,1,1) = {"
GK
kc
TP
TP
TP
AP
Wu
Dw
Ea
GK
Vb
Vb
Vb
Vb
Vb
Vb
Vb
Vb
Vb
Vb
Vb
Vb
"}
(26,1,1) = {"
GK
FK
TP
TP
Er
GK
Wu
CP
Wu
GK
Vb
Vb
Vb
Vb
Vb
Vb
Vb
Vb
Vb
Vb
Vb
Vb
"}
(27,1,1) = {"
GK
JH
TP
Kl
NM
GK
Sa
nS
dG
GK
Vb
Vb
Vb
Vb
Vb
Vb
Vb
Vb
Vb
Vb
Vb
Vb
"}
(28,1,1) = {"
GK
ve
TP
QY
rb
GK
GK
GK
GK
GK
Vb
Vb
Vb
Vb
Vb
Vb
Vb
Vb
Vb
Vb
Vb
Vb
"}
(29,1,1) = {"
GK
GK
GK
GK
GK
GK
Vb
Vb
Vb
Vb
Vb
Vb
Vb
Vb
Vb
Vb
Vb
Vb
Vb
Vb
Vb
Vb
"}
