"am" = (/obj/structure/sign/poster/contraband/power,/turf/closed/wall/r_wall,/area/ruin)
"aE" = (/obj/item/trash/candy,/turf/open/floor/wood/large,/area/ruin)
"bl" = (/obj/structure/bed,/obj/item/bedsheet/dorms,/obj/effect/decal/cleanable/blood/splatter,/turf/open/floor/iron,/area/ruin)
"bn" = (/obj/effect/decal/cleanable/blood/splatter,/turf/open/floor/wood/large,/area/ruin)
"bY" = (/obj/effect/decal/cleanable/oil/slippery,/obj/structure/girder/reinforced,/turf/open/floor/plating/airless,/area/ruin)
"ch" = (/obj/machinery/power/port_gen/pacman,/obj/structure/cable{icon_state = "0-4"},/turf/open/floor/holofloor/asteroid,/area/asteroid)
"cr" = (/obj/machinery/door/airlock/engineering{name = "Engineering"},/turf/open/floor/iron/dark/smooth_half,/area/ruin)
"dd" = (/obj/item/stack/ore/uranium,/turf/open/floor/holofloor/asteroid,/area/asteroid)
"dr" = (/obj/effect/decal/cleanable/oil/slippery,/obj/item/trash/sosjerky,/turf/open/floor/iron/airless,/area/ruin)
"dz" = (/obj/machinery/door/airlock/external,/turf/open/floor/plating,/area/ruin)
"dI" = (/obj/structure/table/wood,/obj/item/gun/ballistic/automatic/pistol/solgov,/turf/open/floor/carpet/nanoweave/blue,/area/ruin)
"em" = (/turf/closed/wall/r_wall,/area/ruin)
"en" = (/obj/effect/decal/cleanable/oil/slippery,/obj/structure/closet/crate,/turf/open/floor/iron,/area/ruin)
"eH" = (/obj/structure/mecha_wreckage/ripley/mkii,/turf/open/floor/holofloor/asteroid,/area/asteroid)
"eI" = (/obj/effect/decal/cleanable/glass,/turf/open/floor/plating/airless,/area/ruin)
"fg" = (/obj/effect/decal/cleanable/blood/tracks{dir = 1},/turf/open/floor/holofloor/asteroid,/area/asteroid)
"fD" = (/obj/effect/decal/cleanable/oil/slippery,/turf/open/floor/iron,/area/ruin)
"fE" = (/obj/item/stack/sheet/mineral/plasma/five,/obj/effect/decal/cleanable/blood/splatter,/turf/open/floor/holofloor/asteroid,/area/asteroid)
"fU" = (/obj/structure/bed,/obj/item/bedsheet/dorms,/turf/open/floor/iron,/area/ruin)
"fW" = (/obj/effect/decal/cleanable/blood/tracks{dir = 1},/obj/machinery/door/airlock/medical/glass{name = "Sick Bay"},/turf/open/floor/iron/dark/smooth_half,/area/ruin)
"fY" = (/obj/effect/decal/cleanable/blood,/obj/effect/mob_spawn/human/corpse/solgov/officer,/turf/open/floor/carpet/nanoweave/blue,/area/ruin)
"gW" = (/obj/structure/table,/obj/item/folder/blue,/turf/open/floor/iron,/area/ruin)
"hc" = (/obj/effect/decal/cleanable/oil/slippery,/obj/structure/closet/crate{icon_state = "crateopen"},/obj/item/flashlight/glowstick/blue,/obj/item/flashlight/glowstick/pink,/obj/item/flashlight/glowstick/orange,/obj/item/flashlight/glowstick/yellow,/obj/item/trash/syndi_cakes,/obj/item/storage/bag/ore,/turf/open/floor/iron,/area/ruin)
"hD" = (/obj/structure/table,/turf/open/floor/iron,/area/ruin)
"ij" = (/obj/structure/table/glass,/obj/item/stack/medical/gauze/twelve,/turf/open/floor/iron,/area/ruin)
"ik" = (/obj/structure/sign/poster/retro/smile,/turf/closed/wall,/area/ruin)
"in" = (/turf/closed/mineral,/area/asteroid)
"iy" = (/obj/structure/closet/crate/engineering,/turf/open/floor/iron,/area/ruin)
"iA" = (/obj/item/stack/ore/uranium,/turf/open/floor/iron,/area/ruin)
"iY" = (/obj/item/trash/candy,/turf/open/floor/iron,/area/ruin)
"kd" = (/obj/structure/sink/puddle,/turf/closed/mineral,/area/asteroid)
"kl" = (/obj/machinery/door/airlock{name = "Dorm 1"},/turf/open/floor/iron/dark/smooth_half,/area/ruin)
"kS" = (/obj/item/trash/can,/turf/open/floor/iron,/area/ruin)
"lE" = (/turf/closed/wall,/area/ruin)
"lQ" = (/obj/item/trash/waffles,/turf/open/floor/iron/airless,/area/ruin)
"mx" = (/obj/machinery/vending/cigarette,/turf/open/floor/iron,/area/ruin)
"nG" = (/obj/structure/closet/crate,/obj/item/stack/ore/iron,/obj/item/stack/ore/iron,/obj/item/stack/ore/iron,/turf/open/floor/iron,/area/ruin)
"op" = (/obj/structure/sign/poster/retro/radio,/turf/closed/wall,/area/ruin)
"or" = (/turf/open/floor/iron/airless,/area/ruin)
"pd" = (/obj/structure/table/wood,/obj/item/flashlight/lamp/green,/turf/open/floor/wood/large,/area/ruin)
"qb" = (/obj/machinery/door/airlock/solgov/glass{name = "Corporate Representative's Office"},/obj/effect/turf_decal/siding/wood{dir = 8},/turf/open/floor/iron/dark/smooth_half{dir = 8},/area/ruin)
"qx" = (/obj/structure/bed,/obj/item/bedsheet/head_of_personnel,/turf/open/floor/carpet/nanoweave/blue,/area/ruin)
"qz" = (/obj/item/stack/ore/uranium,/obj/item/stack/ore/uranium,/turf/open/floor/holofloor/asteroid,/area/asteroid)
"qX" = (/obj/structure/table,/obj/item/paper_bin,/obj/item/pen,/turf/open/floor/iron,/area/ruin)
"re" = (/obj/structure/lattice,/obj/effect/gibspawner/human,/turf/open/space/basic,/area/space)
"sc" = (/obj/machinery/door/airlock{name = "Preparations"},/obj/structure/barricade/wooden/crude,/obj/structure/fans/tiny/invisible,/turf/open/floor/iron/dark/smooth_half,/area/ruin)
"sw" = (/obj/structure/table/glass,/obj/item/stack/medical/suture,/turf/open/floor/iron,/area/ruin)
"tu" = (/obj/machinery/mineral/equipment_vendor,/turf/open/floor/iron/airless,/area/ruin)
"tS" = (/obj/effect/decal/cleanable/blood/splatter,/turf/open/floor/iron,/area/ruin)
"ub" = (/obj/structure/closet/secure_closet/engineering_personal,/turf/open/floor/iron,/area/ruin)
"vf" = (/obj/machinery/door/airlock/command{name = "Control Office"},/turf/open/floor/iron/dark/smooth_half{dir = 8},/area/ruin)
"vh" = (/obj/effect/mob_spawn/human/miner/explorer,/obj/effect/decal/cleanable/blood/gibs/bubblegum,/obj/effect/decal/cleanable/blood,/turf/open/floor/holofloor/asteroid,/area/asteroid)
"wj" = (/obj/structure/table/glass,/obj/item/storage/firstaid/ancient,/turf/open/floor/iron,/area/ruin)
"wD" = (/obj/effect/decal/cleanable/blood/tracks{dir = 4},/turf/open/floor/iron,/area/ruin)
"wF" = (/obj/structure/lattice,/turf/open/space/basic,/area/space)
"xv" = (/obj/effect/decal/cleanable/blood/gibs/torso,/obj/effect/decal/cleanable/blood/splatter,/obj/structure/chair/office/light,/turf/open/floor/iron,/area/ruin)
"xG" = (/obj/effect/decal/cleanable/oil/slippery,/turf/open/floor/iron/airless,/area/ruin)
"yk" = (/obj/structure/sign/poster/ripped,/turf/closed/wall,/area/ruin)
"yN" = (/obj/effect/decal/cleanable/blood/splatter,/turf/open/floor/holofloor/asteroid,/area/asteroid)
"zF" = (/obj/structure/chair/office/light{dir = 4},/turf/open/floor/wood/large,/area/ruin)
"At" = (/obj/structure/table,/obj/item/storage/toolbox/mechanical,/obj/item/multitool,/turf/open/floor/iron,/area/ruin)
"AV" = (/obj/item/stack/ore/plasma,/turf/open/floor/holofloor/asteroid,/area/asteroid)
"Bx" = (/obj/machinery/power/floodlight,/obj/structure/cable{icon_state = "0-8"},/turf/open/floor/holofloor/asteroid,/area/asteroid)
"Cc" = (/obj/effect/decal/cleanable/blood,/obj/structure/bed/roller,/turf/open/floor/iron,/area/ruin)
"CE" = (/obj/structure/closet/crate,/obj/item/stack/ore/titanium,/obj/item/stack/ore/titanium,/turf/open/floor/iron,/area/ruin)
"CJ" = (/obj/effect/decal/cleanable/oil/slippery,/obj/effect/decal/cleanable/blood/tracks{dir = 9},/turf/open/floor/iron,/area/ruin)
"CR" = (/obj/effect/decal/cleanable/oil/slippery,/obj/structure/bed,/obj/item/bedsheet/medical,/turf/open/floor/iron,/area/ruin)
"Di" = (/obj/structure/bed/roller,/turf/open/floor/iron,/area/ruin)
"Dv" = (/turf/open/floor/carpet/nanoweave/blue,/area/ruin)
"DP" = (/obj/item/shard,/obj/effect/decal/cleanable/glass,/turf/open/floor/plating/airless,/area/ruin)
"Eg" = (/obj/structure/closet/crate,/obj/item/stack/ore/gold,/obj/item/stack/ore/gold,/turf/open/floor/iron,/area/ruin)
"ES" = (/obj/structure/table/wood,/obj/machinery/photocopier/faxmachine,/turf/open/floor/carpet/nanoweave/blue,/area/ruin)
"Ft" = (/obj/structure/sign/departments/engineering,/turf/closed/wall,/area/ruin)
"FW" = (/obj/machinery/suit_storage_unit/mining/eva,/turf/open/floor/iron/airless,/area/ruin)
"GD" = (/obj/effect/decal/cleanable/blood/gibs/old,/obj/effect/decal/cleanable/blood,/turf/open/floor/iron/airless,/area/ruin)
"Ho" = (/obj/effect/mob_spawn/human/miner/explorer,/obj/effect/decal/cleanable/blood,/turf/open/floor/holofloor/asteroid,/area/asteroid)
"HL" = (/obj/machinery/power/smes,/turf/open/floor/iron,/area/ruin)
"HP" = (/obj/effect/decal/cleanable/glass,/turf/open/floor/iron/airless,/area/ruin)
"HX" = (/obj/structure/girder/reinforced,/turf/open/floor/plating/airless,/area/ruin)
"Im" = (/obj/effect/mob_spawn/human/miner/explorer,/obj/effect/decal/cleanable/blood,/turf/open/floor/iron,/area/ruin)
"It" = (/turf/closed/mineral/gold,/area/asteroid)
"IR" = (/obj/machinery/door/airlock/external,/obj/structure/fans/tiny,/turf/open/floor/plating,/area/ruin)
"Jg" = (/obj/item/pickaxe/drill,/obj/effect/decal/cleanable/blood/splatter,/turf/open/floor/holofloor/asteroid,/area/asteroid)
"Jn" = (/obj/structure/closet/crate{icon_state = "crateopen"},/obj/item/stack/sheet/mineral/plasma/twenty,/obj/item/stack/ore/diamond,/obj/item/stack/ore/diamond,/turf/open/floor/iron,/area/ruin)
"JT" = (/obj/effect/spawner/structure/window/reinforced,/turf/open/floor/plating,/area/ruin)
"Lz" = (/turf/open/space/basic,/area/space)
"LB" = (/obj/effect/mob_spawn/human/miner/explorer,/obj/effect/decal/cleanable/glass,/obj/effect/decal/cleanable/blood,/turf/open/floor/iron/airless,/area/ruin)
"LI" = (/obj/structure/closet/secure_closet/personal,/turf/open/floor/iron,/area/ruin)
"LU" = (/obj/effect/decal/cleanable/blood/tracks,/turf/open/floor/iron,/area/ruin)
"MO" = (/obj/item/trash/syndi_cakes,/turf/open/floor/iron,/area/ruin)
"Nt" = (/obj/structure/sign/poster/official/space_cops,/turf/closed/wall,/area/ruin)
"Ov" = (/turf/open/floor/wood/large,/area/ruin)
"Oz" = (/obj/effect/decal/cleanable/blood/tracks{dir = 9},/turf/open/floor/iron,/area/ruin)
"OT" = (/obj/effect/decal/cleanable/blood/tracks{dir = 6},/obj/effect/turf_decal/dept/medical,/turf/open/floor/iron,/area/ruin)
"OX" = (/obj/effect/decal/cleanable/oil/slippery,/obj/machinery/vending/coffee,/turf/open/floor/iron,/area/ruin)
"Pk" = (/obj/effect/decal/cleanable/blood/tracks{dir = 6},/turf/open/floor/iron,/area/ruin)
"Px" = (/obj/structure/closet/secure_closet/miner,/turf/open/floor/plating/airless,/area/ruin)
"Py" = (/obj/item/rollingpaper,/turf/open/floor/iron,/area/ruin)
"Pz" = (/obj/structure/table/glass,/turf/open/floor/iron,/area/ruin)
"Qn" = (/obj/structure/closet/cabinet,/turf/open/floor/carpet/nanoweave/blue,/area/ruin)
"Rb" = (/turf/open/floor/iron,/area/ruin)
"Rw" = (/obj/item/stack/ore/uranium,/obj/effect/decal/cleanable/blood,/turf/open/floor/iron,/area/ruin)
"Sp" = (/obj/structure/grille/broken,/obj/item/shard,/obj/effect/decal/cleanable/glass,/turf/open/floor/plating/airless,/area/ruin)
"Ss" = (/obj/machinery/computer{dir = 1; name = "old computer"},/turf/open/floor/iron,/area/ruin)
"SI" = (/obj/machinery/door/airlock/alarmlock{name = "Cargo"},/turf/open/floor/iron/dark/smooth_half{dir = 8},/area/ruin)
"SK" = (/obj/structure/table/wood,/turf/open/floor/wood/large,/area/ruin)
"Tl" = (/obj/item/trash/sosjerky,/turf/open/floor/iron,/area/ruin)
"Tn" = (/obj/machinery/door/airlock/solgov{name = "Representative's Bedroom"},/obj/effect/turf_decal/siding/wood,/turf/open/floor/iron/dark/smooth_half,/area/ruin)
"TE" = (/turf/open/floor/holofloor/asteroid,/area/asteroid)
"Ur" = (/obj/effect/decal/cleanable/oil/slippery,/obj/item/trash/can/food/peaches/maint,/turf/open/floor/iron,/area/ruin)
"UP" = (/turf/open/floor/plating,/area/ruin)
"UZ" = (/obj/structure/closet/crate/bin,/obj/item/trash/can/food/beans,/turf/open/floor/iron,/area/ruin)
"Vd" = (/obj/machinery/computer{name = "old computer"},/turf/open/floor/iron,/area/ruin)
"VE" = (/turf/open/floor/plating/airless,/area/ruin)
"Wk" = (/obj/structure/chair/office/light{dir = 4},/obj/effect/decal/cleanable/blood,/turf/open/floor/iron,/area/ruin)
"Wz" = (/obj/structure/closet/crate,/turf/open/floor/iron,/area/ruin)
"WH" = (/obj/machinery/computer{dir = 8; name = "old computer"},/turf/open/floor/iron,/area/ruin)
"WN" = (/obj/effect/mob_spawn/human/miner/explorer,/obj/item/storage/bag/ore,/obj/effect/decal/cleanable/blood,/turf/open/floor/iron,/area/ruin)
"Xo" = (/obj/effect/decal/cleanable/oil/slippery,/obj/structure/closet/crate{icon_state = "crateopen"},/obj/item/flashlight,/turf/open/floor/iron,/area/ruin)
"Xr" = (/obj/effect/decal/cleanable/blood,/turf/open/floor/plating/airless,/area/ruin)
"Xy" = (/obj/machinery/door/airlock{name = "Dorm 2"},/turf/open/floor/iron/dark/smooth_half,/area/ruin)
"XN" = (/obj/structure/closet/crate{icon_state = "crateopen"},/obj/item/flashlight,/obj/item/reagent_containers/food/drinks/soda_cans/plasma,/obj/item/stack/ore/bluespace_crystal,/turf/open/floor/iron,/area/ruin)
"XP" = (/obj/item/flashlight/flare,/obj/effect/decal/cleanable/blood/tracks,/turf/open/floor/iron,/area/ruin)
"Yc" = (/obj/effect/decal/cleanable/oil/slippery,/obj/machinery/door/airlock/alarmlock{name = "Cargo"},/turf/open/floor/iron/dark/smooth_half{dir = 8},/area/ruin)

(1,1,1) = {"
LzLzLzLzLzLzLzLzLzLzLzLzLzLzLzLzLzLzLzLzLzLzLzLzLzLzLzLzLzLzLzLzLzLzLzLzLzLzLzLzLzLzLzLzLzLzLzLzLzLz
LzLzLzLzLzLzLzLzLzLzLzLzLzLzLzLzLzLzLzLzLzLzLzLzLzLzLzLzLzLzLzLzLzLzLzLzLzLzLzLzLzLzLzLzLzLzLzLzLzLz
LzLzLzLzLzLzLzLzLzLzLzLzLzLzLzLzLzLzLzLzLzLzLzLzLzLzLzLzLzLzLzLzLzLzLzLzLzLzLzLzLzLzLzLzLzLzLzLzLzLz
LzLzLzLzLzLzLzLzLzLzLzLzLzLzLzLzLzLzLzLzLzLzLzLzLzLzLzLzLzLzLzLzLzLzLzLzLzLzLzLzLzLzLzLzLzLzLzLzLzLz
LzLzLzLzLzLzLzLzLzLzLzLzLzLzLzLzLzLzLzLzLzLzLzLzLzLzLzLzLzLzLzLzLzLzLzLzLzLzLzLzLzLzLzLzLzLzLzLzLzLz
LzLzLzLzLzLzLzLzLzLzLzLzLzLzLzLzLzLzLzLzLzLzLzLzLzLzLzLzLzLzLzLzLzLzLzLzLzLzLzLzLzLzLzLzLzLzLzLzLzLz
LzLzLzLzLzLzLzLzLzLzLzLzLzLzLzLzLzLzLzLzLzLzLzLzLzLzLzLzLzLzLzLzLzLzLzLzLzLzLzLzLzLzLzLzLzLzLzLzLzLz
LzLzLzLzLzLzLzLzLzLzLzLzLzLzLzLzLzLzLzLzLzLzLzLzLzLzLzLzLzLzLzLzLzLzLzLzLzLzLzLzLzLzLzLzLzLzLzLzLzLz
LzLzLzLzLzLzLzLzinLzLzLzLzLzLzLzLzLzLzLzLzLzLzLzLzLzLzLzLzLzLzLzLzLzLzLzLzLzLzLzLzLzLzLzLzLzLzLzLzLz
LzLzLzLzLzLzLzinininLzLzLzLzLzLzLzLzLzLzLzLzLzLzLzLzLzLzLzLzLzLzLzLzLzLzLzLzLzLzLzLzLzLzLzLzLzLzLzLz
LzLzLzLzLzLzinininininLzLzLzLzLzLzLzLzLzLzLzLzLzLzLzLzLzLzininLzLzLzLzLzLzLzLzLzLzLzLzLzLzLzLzLzLzLz
LzLzLzLzLzLzinininininininLzLzLzLzLzLzLzLzLzLzLzLzLzLzininininininLzLzLzLzLzLzLzLzLzLzLzLzLzLzLzLzLz
LzLzLzLzLzinininininininininLzLzLzLzLzLzLzLzLzLzLzLzininininininininLzLzLzLzLzLzLzLzLzLzLzLzLzLzLzLz
LzLzLzininininininininininininLzLzLzLzLzLzLzLzLzininininininininininLzLzLzLzLzLzLzLzLzLzLzLzLzLzLzLz
LzLzTEinininininininininininTETETELzLzLzLzLzinininininininininininininLzLzLzLzLzLzLzLzLzLzLzLzLzLzLz
LzLzTETEininininininTEininTETETETETETETELzininininininininininininininLzLzLzLzLzLzLzLzLzLzLzLzLzLzLz
LzLzLzTETEininininTETETETETETEchBxTEHoTETETEinininininininininininininininLzLzLzLzLzLzLzLzLzLzLzLzLz
LzLzLzTETETETEininTEeHTETETEfETETETETETETEinininininininininininininininininLzLzLzLzLzLzLzLzLzLzLzLz
LzLzLzinTETETEinTEyNTETETEHoTETETEJgTETETEinininininininininininininininininLzLzLzLzLzLzLzLzLzLzLzLz
LzLzinininTETETETETETETEItItTETETETEinininininininininininininininininininininLzLzLzLzLzLzLzLzLzLzLz
LzLzLzinininTETETETETEininininininininininItinininItinininininkdinininininLzLzLzLzLzLzLzLzLzLzLzLzLz
LzLzLzLzininTETETETEinItininininininininininininininininininininininininLzLzLzLzLzLzLzLzLzLzLzLzLzLz
LzLzLzLzinininTETEinininememamemememememememememememememememininininininLzLzLzLzLzLzLzLzLzLzLzLzLzLz
LzLzLzLzinininTETEinininemHLHLVdiylELIRbLIlELIRbLIlEijwjCReminininininLzLzLzLzLzLzLzLzLzLzLzLzLzLzLz
LzLzLzinininTETETEinininemfDRbtSRblERbfDTllERbRbMOlEPzRbCcememememememLzLzLzLzLzLzLzLzLzLzLzLzLzLzLz
LzLzininininTETEininininemRbRbfDublEfURbfUlEblfDfUlEswOzPkemAtRbRbWHJTLzLzLzLzLzLzLzLzLzLzLzLzLzLzLz
LzLzinininTETETEininemememememcrFtyklEkllENtlEXylEoplEfWlEemUrRbWkWHJTLzLzLzLzLzLzLzLzLzLzLzLzLzLzLz
LzLzininTETETETEininemESdIQnemRbRbDiRbfDRbRbRbRbRbImwDOTRbvfRbiYRbWHJTLzLzLzLzLzLzLzLzLzLzLzLzLzLzLz
LzininTETETETEininItemDvDvfYemRbCJwDtSPyRbRbfDRbkSRbRbRbRbJTRbxvRbhDJTLzLzLzLzLzLzLzLzLzLzLzLzLzLzLz
LzininTETETETEinininemDvDvqxemRbLUlElEiklElEUZmxOXlElEsclElEhDSsqXgWJTLzLzLzLzLzLzLzLzLzLzLzLzLzLzLz
inininTEvhTEAVinininemTnemememRbXPlEJnRbCElElElElElEGDlQorememJTJTJTJTLzLzLzLzLzLzLzLzLzLzLzLzLzLzLz
inininTEfgAVAVinininembnpdOvemfDWNSIRbRbenlEFWFWFWJTorVExGemLzLzLzLzLzLzLzLzLzLzLzLzLzLzLzLzLzLzLzLz
inininTEfgTETEinItinemzFSKbnqbRwiAYcRbRbXNlEordrHPSpDPVEXrHXLzLzwFLzLzLzLzLzLzLzLzLzLzLzLzLzLzLzLzLz
ininininyNTETETEininemOvOvaEemiARblEWzfDEglEorLBDPXreIreVEVELzwFwFLzLzLzLzLzLzLzLzLzLzLzLzLzLzLzLzLz
inininItItTETETEItinemememememdzdzlEnGRbhclEtuPxVEHXwFwFwFwFwFLzLzLzLzLzLzLzLzLzLzLzLzLzLzLzLzLzLzLz
LzininininTEddTETEinininininemUPUPlEXoRbWzememembYXrwFLzLzwFLzwFwFLzLzLzLzLzLzLzLzLzLzLzLzLzLzLzLzLz
LzLzinininqzddTETETEininininemIRIRemememememItItLzwFwFLzwFLzLzwFLzLzLzLzLzLzLzLzLzLzLzLzLzLzLzLzLzLz
LzLzLzinininTETETETETETEinininTETEininininItItinLzLzLzLzLzLzLzwFLzLzLzLzLzLzLzLzLzLzLzLzLzLzLzLzLzLz
LzLzLzLzinininTETETETETETETETETETETEinItininininLzLzLzLzLzLzLzLzLzLzLzLzLzLzLzLzLzLzLzLzLzLzLzLzLzLz
LzLzLzLzLzinininininTETETETETETETETEinininininininLzLzLzLzLzLzLzLzLzLzLzLzLzLzLzLzLzLzLzLzLzLzLzLzLz
LzLzLzLzLzLzLzininininTETETETETETETEininininininLzLzLzLzLzLzLzLzLzLzLzLzLzLzLzLzLzLzLzLzLzLzLzLzLzLz
LzLzLzLzLzLzLzLzininininTETETETETEinininininininLzLzLzLzLzLzLzLzLzLzLzLzLzLzLzLzLzLzLzLzLzLzLzLzLzLz
LzLzLzLzLzLzLzLzLzininTETETETETEininininLzininLzLzLzLzLzLzLzLzLzLzLzLzLzLzLzLzLzLzLzLzLzLzLzLzLzLzLz
LzLzLzLzLzLzLzLzLzininTETETETEininLzinLzLzinLzLzLzLzLzLzLzLzLzLzLzLzLzLzLzLzLzLzLzLzLzLzLzLzLzLzLzLz
LzLzLzLzLzLzLzLzLzininTETETEininLzLzLzLzLzLzLzLzLzLzLzLzLzLzLzLzLzLzLzLzLzLzLzLzLzLzLzLzLzLzLzLzLzLz
LzLzLzLzLzLzLzLzinininTETETETEinLzLzLzLzLzLzLzLzLzLzLzLzLzLzLzLzLzLzLzLzLzLzLzLzLzLzLzLzLzLzLzLzLzLz
LzLzLzLzLzLzLzLzinLzinTETETELzLzLzLzLzLzLzLzLzLzLzLzLzLzLzLzLzLzLzLzLzLzLzLzLzLzLzLzLzLzLzLzLzLzLzLz
LzLzLzLzLzLzLzLzLzLzLzTETELzLzLzLzLzLzLzLzLzLzLzLzLzLzLzLzLzLzLzLzLzLzLzLzLzLzLzLzLzLzLzLzLzLzLzLzLz
LzLzLzLzLzLzLzLzLzLzLzLzLzLzLzLzLzLzLzLzLzLzLzLzLzLzLzLzLzLzLzLzLzLzLzLzLzLzLzLzLzLzLzLzLzLzLzLzLzLz
LzLzLzLzLzLzLzLzLzLzLzLzLzLzLzLzLzLzLzLzLzLzLzLzLzLzLzLzLzLzLzLzLzLzLzLzLzLzLzLzLzLzLzLzLzLzLzLzLzLz
"}
