//MAP CONVERTED BY dmm2tgm.py THIS HEADER COMMENT PREVENTS RECONVERSION, DO NOT REMOVE
"am" = (
/obj/structure/sign/poster/contraband/power,
/turf/closed/wall/r_wall,
/area/ruin)
"aE" = (
/obj/item/trash/candy,
/turf/open/floor/wood/large,
/area/ruin)
"bl" = (
/obj/structure/bed,
/obj/item/bedsheet/dorms,
/obj/effect/decal/cleanable/blood/splatter,
/turf/open/floor/iron,
/area/ruin)
"bn" = (
/obj/effect/decal/cleanable/blood/splatter,
/turf/open/floor/wood/large,
/area/ruin)
"bY" = (
/obj/effect/decal/cleanable/oil/slippery,
/obj/structure/girder/reinforced,
/turf/open/floor/plating/airless,
/area/ruin)
"ch" = (
/obj/machinery/power/port_gen/pacman,
/obj/structure/cable{
	icon_state = "0-4"
	},
/turf/open/floor/holofloor/asteroid,
/area/asteroid)
"cr" = (
/obj/machinery/door/airlock/engineering{
	name = "Engineering"
	},
/turf/open/floor/iron/dark/smooth_half,
/area/ruin)
"dd" = (
/obj/item/stack/ore/uranium,
/turf/open/floor/holofloor/asteroid,
/area/asteroid)
"dr" = (
/obj/effect/decal/cleanable/oil/slippery,
/obj/item/trash/sosjerky,
/turf/open/floor/iron/airless,
/area/ruin)
"dz" = (
/obj/machinery/door/airlock/external,
/turf/open/floor/plating,
/area/ruin)
"dI" = (
/obj/structure/table/wood,
/obj/item/gun/ballistic/automatic/pistol/solgov,
/turf/open/floor/carpet/nanoweave/blue,
/area/ruin)
"em" = (
/turf/closed/wall/r_wall,
/area/ruin)
"en" = (
/obj/effect/decal/cleanable/oil/slippery,
/obj/structure/closet/crate,
/turf/open/floor/iron,
/area/ruin)
"eH" = (
/obj/structure/mecha_wreckage/ripley/mkii,
/turf/open/floor/holofloor/asteroid,
/area/asteroid)
"eI" = (
/obj/effect/decal/cleanable/glass,
/turf/open/floor/plating/airless,
/area/ruin)
"fg" = (
/obj/effect/decal/cleanable/blood/tracks{
	dir = 1
	},
/turf/open/floor/holofloor/asteroid,
/area/asteroid)
"fD" = (
/obj/effect/decal/cleanable/oil/slippery,
/turf/open/floor/iron,
/area/ruin)
"fE" = (
/obj/item/stack/sheet/mineral/plasma/five,
/obj/effect/decal/cleanable/blood/splatter,
/turf/open/floor/holofloor/asteroid,
/area/asteroid)
"fU" = (
/obj/structure/bed,
/obj/item/bedsheet/dorms,
/turf/open/floor/iron,
/area/ruin)
"fW" = (
/obj/effect/decal/cleanable/blood/tracks{
	dir = 1
	},
/obj/machinery/door/airlock/medical/glass{
	name = "Sick Bay"
	},
/turf/open/floor/iron/dark/smooth_half,
/area/ruin)
"fY" = (
/obj/effect/decal/cleanable/blood,
/obj/effect/mob_spawn/human/corpse/solgov/officer,
/turf/open/floor/carpet/nanoweave/blue,
/area/ruin)
"gW" = (
/obj/structure/table,
/obj/item/folder/blue,
/turf/open/floor/iron,
/area/ruin)
"hc" = (
/obj/effect/decal/cleanable/oil/slippery,
/obj/structure/closet/crate{
	icon_state = "crateopen"
	},
/obj/item/flashlight/glowstick/blue,
/obj/item/flashlight/glowstick/pink,
/obj/item/flashlight/glowstick/orange,
/obj/item/flashlight/glowstick/yellow,
/obj/item/trash/syndi_cakes,
/obj/item/storage/bag/ore,
/turf/open/floor/iron,
/area/ruin)
"hD" = (
/obj/structure/table,
/turf/open/floor/iron,
/area/ruin)
"ij" = (
/obj/structure/table/glass,
/obj/item/stack/medical/gauze/twelve,
/turf/open/floor/iron,
/area/ruin)
"ik" = (
/obj/structure/sign/poster/retro/smile,
/turf/closed/wall,
/area/ruin)
"in" = (
/turf/closed/mineral,
/area/asteroid)
"iy" = (
/obj/structure/closet/crate/engineering,
/turf/open/floor/iron,
/area/ruin)
"iA" = (
/obj/item/stack/ore/uranium,
/turf/open/floor/iron,
/area/ruin)
"iY" = (
/obj/item/trash/candy,
/turf/open/floor/iron,
/area/ruin)
"kd" = (
/obj/structure/sink/puddle,
/turf/closed/mineral,
/area/asteroid)
"kl" = (
/obj/machinery/door/airlock{
	name = "Dorm 1"
	},
/turf/open/floor/iron/dark/smooth_half,
/area/ruin)
"kS" = (
/obj/item/trash/can,
/turf/open/floor/iron,
/area/ruin)
"lE" = (
/turf/closed/wall,
/area/ruin)
"lQ" = (
/obj/item/trash/waffles,
/turf/open/floor/iron/airless,
/area/ruin)
"mx" = (
/obj/machinery/vending/cigarette,
/turf/open/floor/iron,
/area/ruin)
"nG" = (
/obj/structure/closet/crate,
/obj/item/stack/ore/iron,
/obj/item/stack/ore/iron,
/obj/item/stack/ore/iron,
/turf/open/floor/iron,
/area/ruin)
"op" = (
/obj/structure/sign/poster/retro/radio,
/turf/closed/wall,
/area/ruin)
"or" = (
/turf/open/floor/iron/airless,
/area/ruin)
"pd" = (
/obj/structure/table/wood,
/obj/item/flashlight/lamp/green,
/turf/open/floor/wood/large,
/area/ruin)
"qb" = (
/obj/machinery/door/airlock/solgov/glass{
	name = "Corporate Representative's Office"
	},
/obj/effect/turf_decal/siding/wood{
	dir = 8
	},
/turf/open/floor/iron/dark/smooth_half{
	dir = 8
	},
/area/ruin)
"qx" = (
/obj/structure/bed,
/obj/item/bedsheet/head_of_personnel,
/turf/open/floor/carpet/nanoweave/blue,
/area/ruin)
"qz" = (
/obj/item/stack/ore/uranium,
/obj/item/stack/ore/uranium,
/turf/open/floor/holofloor/asteroid,
/area/asteroid)
"qX" = (
/obj/structure/table,
/obj/item/paper_bin,
/obj/item/pen,
/turf/open/floor/iron,
/area/ruin)
"re" = (
/obj/structure/lattice,
/obj/effect/gibspawner/human,
/turf/open/space/basic,
/area/space)
"sc" = (
/obj/machinery/door/airlock{
	name = "Preparations"
	},
/obj/structure/barricade/wooden/crude,
/obj/structure/fans/tiny/invisible,
/turf/open/floor/iron/dark/smooth_half,
/area/ruin)
"sw" = (
/obj/structure/table/glass,
/obj/item/stack/medical/suture,
/turf/open/floor/iron,
/area/ruin)
"tu" = (
/obj/machinery/mineral/equipment_vendor,
/turf/open/floor/iron/airless,
/area/ruin)
"tS" = (
/obj/effect/decal/cleanable/blood/splatter,
/turf/open/floor/iron,
/area/ruin)
"ub" = (
/obj/structure/closet/secure_closet/engineering_personal,
/turf/open/floor/iron,
/area/ruin)
"vf" = (
/obj/machinery/door/airlock/command{
	name = "Control Office"
	},
/turf/open/floor/iron/dark/smooth_half{
	dir = 8
	},
/area/ruin)
"vh" = (
/obj/effect/mob_spawn/human/miner/explorer,
/obj/effect/decal/cleanable/blood/gibs/bubblegum,
/obj/effect/decal/cleanable/blood,
/turf/open/floor/holofloor/asteroid,
/area/asteroid)
"wj" = (
/obj/structure/table/glass,
/obj/item/storage/firstaid/ancient,
/turf/open/floor/iron,
/area/ruin)
"wD" = (
/obj/effect/decal/cleanable/blood/tracks{
	dir = 4
	},
/turf/open/floor/iron,
/area/ruin)
"wF" = (
/obj/structure/lattice,
/turf/open/space/basic,
/area/space)
"xv" = (
/obj/effect/decal/cleanable/blood/gibs/torso,
/obj/effect/decal/cleanable/blood/splatter,
/obj/structure/chair/office/light,
/turf/open/floor/iron,
/area/ruin)
"xG" = (
/obj/effect/decal/cleanable/oil/slippery,
/turf/open/floor/iron/airless,
/area/ruin)
"yk" = (
/obj/structure/sign/poster/ripped,
/turf/closed/wall,
/area/ruin)
"yN" = (
/obj/effect/decal/cleanable/blood/splatter,
/turf/open/floor/holofloor/asteroid,
/area/asteroid)
"zF" = (
/obj/structure/chair/office/light{
	dir = 4
	},
/turf/open/floor/wood/large,
/area/ruin)
"At" = (
/obj/structure/table,
/obj/item/storage/toolbox/mechanical,
/obj/item/multitool,
/turf/open/floor/iron,
/area/ruin)
"AV" = (
/obj/item/stack/ore/plasma,
/turf/open/floor/holofloor/asteroid,
/area/asteroid)
"Bx" = (
/obj/machinery/power/floodlight,
/obj/structure/cable{
	icon_state = "0-8"
	},
/turf/open/floor/holofloor/asteroid,
/area/asteroid)
"Cc" = (
/obj/effect/decal/cleanable/blood,
/obj/structure/bed/roller,
/turf/open/floor/iron,
/area/ruin)
"CE" = (
/obj/structure/closet/crate,
/obj/item/stack/ore/titanium,
/obj/item/stack/ore/titanium,
/turf/open/floor/iron,
/area/ruin)
"CJ" = (
/obj/effect/decal/cleanable/oil/slippery,
/obj/effect/decal/cleanable/blood/tracks{
	dir = 9
	},
/turf/open/floor/iron,
/area/ruin)
"CR" = (
/obj/effect/decal/cleanable/oil/slippery,
/obj/structure/bed,
/obj/item/bedsheet/medical,
/turf/open/floor/iron,
/area/ruin)
"Di" = (
/obj/structure/bed/roller,
/turf/open/floor/iron,
/area/ruin)
"Dv" = (
/turf/open/floor/carpet/nanoweave/blue,
/area/ruin)
"DP" = (
/obj/item/shard,
/obj/effect/decal/cleanable/glass,
/turf/open/floor/plating/airless,
/area/ruin)
"Eg" = (
/obj/structure/closet/crate,
/obj/item/stack/ore/gold,
/obj/item/stack/ore/gold,
/turf/open/floor/iron,
/area/ruin)
"ES" = (
/obj/structure/table/wood,
/obj/machinery/photocopier/faxmachine,
/turf/open/floor/carpet/nanoweave/blue,
/area/ruin)
"Ft" = (
/obj/structure/sign/departments/engineering,
/turf/closed/wall,
/area/ruin)
"FW" = (
/obj/machinery/suit_storage_unit/mining/eva,
/turf/open/floor/iron/airless,
/area/ruin)
"GD" = (
/obj/effect/decal/cleanable/blood/gibs/old,
/obj/effect/decal/cleanable/blood,
/turf/open/floor/iron/airless,
/area/ruin)
"Ho" = (
/obj/effect/mob_spawn/human/miner/explorer,
/obj/effect/decal/cleanable/blood,
/turf/open/floor/holofloor/asteroid,
/area/asteroid)
"HL" = (
/obj/machinery/power/smes,
/turf/open/floor/iron,
/area/ruin)
"HP" = (
/obj/effect/decal/cleanable/glass,
/turf/open/floor/iron/airless,
/area/ruin)
"HX" = (
/obj/structure/girder/reinforced,
/turf/open/floor/plating/airless,
/area/ruin)
"Im" = (
/obj/effect/mob_spawn/human/miner/explorer,
/obj/effect/decal/cleanable/blood,
/turf/open/floor/iron,
/area/ruin)
"It" = (
/turf/closed/mineral/gold,
/area/asteroid)
"IR" = (
/obj/machinery/door/airlock/external,
/obj/structure/fans/tiny,
/turf/open/floor/plating,
/area/ruin)
"Jg" = (
/obj/item/pickaxe/drill,
/obj/effect/decal/cleanable/blood/splatter,
/turf/open/floor/holofloor/asteroid,
/area/asteroid)
"Jn" = (
/obj/structure/closet/crate{
	icon_state = "crateopen"
	},
/obj/item/stack/sheet/mineral/plasma/twenty,
/obj/item/stack/ore/diamond,
/obj/item/stack/ore/diamond,
/turf/open/floor/iron,
/area/ruin)
"JT" = (
/obj/effect/spawner/structure/window/reinforced,
/turf/open/floor/plating,
/area/ruin)
"Lz" = (
/turf/open/space/basic,
/area/space)
"LB" = (
/obj/effect/mob_spawn/human/miner/explorer,
/obj/effect/decal/cleanable/glass,
/obj/effect/decal/cleanable/blood,
/turf/open/floor/iron/airless,
/area/ruin)
"LI" = (
/obj/structure/closet/secure_closet/personal,
/turf/open/floor/iron,
/area/ruin)
"LU" = (
/obj/effect/decal/cleanable/blood/tracks,
/turf/open/floor/iron,
/area/ruin)
"MO" = (
/obj/item/trash/syndi_cakes,
/turf/open/floor/iron,
/area/ruin)
"Nt" = (
/obj/structure/sign/poster/contraband/space_cops,
/turf/closed/wall,
/area/ruin)
"Ov" = (
/turf/open/floor/wood/large,
/area/ruin)
"Oz" = (
/obj/effect/decal/cleanable/blood/tracks{
	dir = 9
	},
/turf/open/floor/iron,
/area/ruin)
"OT" = (
/obj/effect/decal/cleanable/blood/tracks{
	dir = 6
	},
/obj/effect/turf_decal/dept/medical,
/turf/open/floor/iron,
/area/ruin)
"OX" = (
/obj/effect/decal/cleanable/oil/slippery,
/obj/machinery/vending/coffee,
/turf/open/floor/iron,
/area/ruin)
"Pk" = (
/obj/effect/decal/cleanable/blood/tracks{
	dir = 6
	},
/turf/open/floor/iron,
/area/ruin)
"Px" = (
/obj/structure/closet/secure_closet/miner,
/turf/open/floor/plating/airless,
/area/ruin)
"Py" = (
/obj/item/rollingpaper,
/turf/open/floor/iron,
/area/ruin)
"Pz" = (
/obj/structure/table/glass,
/turf/open/floor/iron,
/area/ruin)
"Qn" = (
/obj/structure/closet/cabinet,
/turf/open/floor/carpet/nanoweave/blue,
/area/ruin)
"Rb" = (
/turf/open/floor/iron,
/area/ruin)
"Rw" = (
/obj/item/stack/ore/uranium,
/obj/effect/decal/cleanable/blood,
/turf/open/floor/iron,
/area/ruin)
"Sp" = (
/obj/structure/grille/broken,
/obj/item/shard,
/obj/effect/decal/cleanable/glass,
/turf/open/floor/plating/airless,
/area/ruin)
"Ss" = (
/obj/machinery/computer{
	dir = 1;
	name = "old computer"
	},
/turf/open/floor/iron,
/area/ruin)
"SI" = (
/obj/machinery/door/airlock/alarmlock{
	name = "Cargo"
	},
/turf/open/floor/iron/dark/smooth_half{
	dir = 8
	},
/area/ruin)
"SK" = (
/obj/structure/table/wood,
/turf/open/floor/wood/large,
/area/ruin)
"Tl" = (
/obj/item/trash/sosjerky,
/turf/open/floor/iron,
/area/ruin)
"Tn" = (
/obj/machinery/door/airlock/solgov{
	name = "Representative's Bedroom"
	},
/obj/effect/turf_decal/siding/wood,
/turf/open/floor/iron/dark/smooth_half,
/area/ruin)
"TE" = (
/turf/open/floor/holofloor/asteroid,
/area/asteroid)
"Ur" = (
/obj/effect/decal/cleanable/oil/slippery,
/obj/item/trash/can/food/peaches/maint,
/turf/open/floor/iron,
/area/ruin)
"UP" = (
/turf/open/floor/plating,
/area/ruin)
"UZ" = (
/obj/structure/closet/crate/bin,
/obj/item/trash/can/food/beans,
/turf/open/floor/iron,
/area/ruin)
"Vd" = (
/obj/machinery/computer{
	name = "old computer"
	},
/turf/open/floor/iron,
/area/ruin)
"VE" = (
/turf/open/floor/plating/airless,
/area/ruin)
"Wk" = (
/obj/structure/chair/office/light{
	dir = 4
	},
/obj/effect/decal/cleanable/blood,
/turf/open/floor/iron,
/area/ruin)
"Wz" = (
/obj/structure/closet/crate,
/turf/open/floor/iron,
/area/ruin)
"WH" = (
/obj/machinery/computer{
	dir = 8;
	name = "old computer"
	},
/turf/open/floor/iron,
/area/ruin)
"WN" = (
/obj/effect/mob_spawn/human/miner/explorer,
/obj/item/storage/bag/ore,
/obj/effect/decal/cleanable/blood,
/turf/open/floor/iron,
/area/ruin)
"Xo" = (
/obj/effect/decal/cleanable/oil/slippery,
/obj/structure/closet/crate{
	icon_state = "crateopen"
	},
/obj/item/flashlight,
/turf/open/floor/iron,
/area/ruin)
"Xr" = (
/obj/effect/decal/cleanable/blood,
/turf/open/floor/plating/airless,
/area/ruin)
"Xy" = (
/obj/machinery/door/airlock{
	name = "Dorm 2"
	},
/turf/open/floor/iron/dark/smooth_half,
/area/ruin)
"XN" = (
/obj/structure/closet/crate{
	icon_state = "crateopen"
	},
/obj/item/flashlight,
/obj/item/reagent_containers/food/drinks/soda_cans/plasma,
/obj/item/stack/ore/bluespace_crystal,
/turf/open/floor/iron,
/area/ruin)
"XP" = (
/obj/item/flashlight/flare,
/obj/effect/decal/cleanable/blood/tracks,
/turf/open/floor/iron,
/area/ruin)
"Yc" = (
/obj/effect/decal/cleanable/oil/slippery,
/obj/machinery/door/airlock/alarmlock{
	name = "Cargo"
	},
/turf/open/floor/iron/dark/smooth_half{
	dir = 8
	},
/area/ruin)

(1,1,1) = {"
Lz
Lz
Lz
Lz
Lz
Lz
Lz
Lz
Lz
Lz
Lz
Lz
Lz
Lz
Lz
Lz
Lz
Lz
Lz
Lz
Lz
Lz
Lz
Lz
Lz
Lz
Lz
Lz
Lz
Lz
in
in
in
in
in
Lz
Lz
Lz
Lz
Lz
Lz
Lz
Lz
Lz
Lz
Lz
Lz
Lz
Lz
Lz
"}
(2,1,1) = {"
Lz
Lz
Lz
Lz
Lz
Lz
Lz
Lz
Lz
Lz
Lz
Lz
Lz
Lz
Lz
Lz
Lz
Lz
Lz
Lz
Lz
Lz
Lz
Lz
Lz
Lz
Lz
Lz
in
in
in
in
in
in
in
in
Lz
Lz
Lz
Lz
Lz
Lz
Lz
Lz
Lz
Lz
Lz
Lz
Lz
Lz
"}
(3,1,1) = {"
Lz
Lz
Lz
Lz
Lz
Lz
Lz
Lz
Lz
Lz
Lz
Lz
Lz
Lz
TE
TE
Lz
Lz
Lz
in
Lz
Lz
Lz
Lz
Lz
in
in
in
in
in
in
in
in
in
in
in
in
Lz
Lz
Lz
Lz
Lz
Lz
Lz
Lz
Lz
Lz
Lz
Lz
Lz
"}
(4,1,1) = {"
Lz
Lz
Lz
Lz
Lz
Lz
Lz
Lz
Lz
Lz
Lz
Lz
Lz
in
in
TE
TE
TE
in
in
in
Lz
Lz
Lz
in
in
in
in
TE
TE
TE
TE
TE
in
It
in
in
in
Lz
Lz
Lz
Lz
Lz
Lz
Lz
Lz
Lz
Lz
Lz
Lz
"}
(5,1,1) = {"
Lz
Lz
Lz
Lz
Lz
Lz
Lz
Lz
Lz
Lz
Lz
Lz
Lz
in
in
in
TE
TE
TE
in
in
in
in
in
in
in
in
TE
TE
TE
vh
fg
fg
yN
It
in
in
in
in
Lz
Lz
Lz
Lz
Lz
Lz
Lz
Lz
Lz
Lz
Lz
"}
(6,1,1) = {"
Lz
Lz
Lz
Lz
Lz
Lz
Lz
Lz
Lz
Lz
Lz
Lz
in
in
in
in
in
TE
TE
TE
in
in
in
in
in
in
TE
TE
TE
TE
TE
AV
TE
TE
TE
TE
qz
in
in
in
Lz
Lz
Lz
Lz
Lz
Lz
Lz
Lz
Lz
Lz
"}
(7,1,1) = {"
Lz
Lz
Lz
Lz
Lz
Lz
Lz
Lz
Lz
Lz
in
in
in
in
in
in
in
TE
TE
TE
TE
TE
in
in
TE
TE
TE
TE
TE
TE
AV
AV
TE
TE
TE
dd
dd
TE
in
in
Lz
Lz
Lz
Lz
Lz
Lz
Lz
Lz
Lz
Lz
"}
(8,1,1) = {"
Lz
Lz
Lz
Lz
Lz
Lz
Lz
Lz
Lz
in
in
in
in
in
in
in
in
in
in
TE
TE
TE
TE
TE
TE
TE
TE
TE
in
in
in
in
in
TE
TE
TE
TE
TE
TE
in
in
Lz
Lz
Lz
Lz
Lz
Lz
Lz
Lz
Lz
"}
(9,1,1) = {"
Lz
Lz
Lz
Lz
Lz
Lz
Lz
Lz
in
in
in
in
in
in
in
in
in
in
TE
TE
TE
TE
TE
TE
TE
in
in
in
in
in
in
in
It
in
It
TE
TE
TE
TE
in
in
in
Lz
Lz
Lz
in
in
Lz
Lz
Lz
"}
(10,1,1) = {"
Lz
Lz
Lz
Lz
Lz
Lz
Lz
Lz
Lz
in
in
in
in
in
in
in
TE
TE
yN
TE
TE
TE
in
in
in
in
in
in
It
in
in
in
in
in
in
in
TE
TE
TE
in
in
in
in
in
in
in
Lz
Lz
Lz
Lz
"}
(11,1,1) = {"
Lz
Lz
Lz
Lz
Lz
Lz
Lz
Lz
Lz
Lz
in
in
in
in
in
TE
TE
eH
TE
TE
TE
in
in
in
in
in
em
em
em
em
em
em
em
em
em
in
in
TE
TE
TE
in
in
in
in
in
in
in
Lz
Lz
Lz
"}
(12,1,1) = {"
Lz
Lz
Lz
Lz
Lz
Lz
Lz
Lz
Lz
Lz
Lz
in
in
in
in
in
TE
TE
TE
TE
in
It
in
in
in
in
em
ES
Dv
Dv
Tn
bn
zF
Ov
em
in
in
TE
TE
TE
TE
in
TE
TE
TE
TE
TE
TE
Lz
Lz
"}
(13,1,1) = {"
Lz
Lz
Lz
Lz
Lz
Lz
Lz
Lz
Lz
Lz
Lz
in
in
in
in
in
TE
TE
TE
It
in
in
em
em
em
em
em
dI
Dv
Dv
em
pd
SK
Ov
em
in
in
in
TE
TE
TE
TE
TE
TE
TE
TE
TE
TE
Lz
Lz
"}
(14,1,1) = {"
Lz
Lz
Lz
Lz
Lz
Lz
Lz
Lz
Lz
Lz
Lz
Lz
in
in
in
TE
TE
TE
Ho
It
in
in
em
HL
fD
Rb
em
Qn
fY
qx
em
Ov
bn
aE
em
in
in
in
TE
TE
TE
TE
TE
TE
TE
TE
TE
Lz
Lz
Lz
"}
(15,1,1) = {"
Lz
Lz
Lz
Lz
Lz
Lz
Lz
Lz
Lz
Lz
Lz
Lz
Lz
in
TE
TE
TE
fE
TE
TE
in
in
am
HL
Rb
Rb
em
em
em
em
em
em
qb
em
em
em
em
in
TE
TE
TE
TE
TE
TE
in
TE
Lz
Lz
Lz
Lz
"}
(16,1,1) = {"
Lz
Lz
Lz
Lz
Lz
Lz
Lz
Lz
Lz
Lz
Lz
Lz
Lz
Lz
TE
TE
ch
TE
TE
TE
in
in
em
Vd
tS
fD
cr
Rb
Rb
Rb
Rb
fD
Rw
iA
dz
UP
IR
TE
TE
TE
TE
TE
TE
in
in
in
Lz
Lz
Lz
Lz
"}
(17,1,1) = {"
Lz
Lz
Lz
Lz
Lz
Lz
Lz
Lz
Lz
Lz
Lz
Lz
Lz
Lz
TE
TE
Bx
TE
TE
TE
in
in
em
iy
Rb
ub
Ft
Rb
CJ
LU
XP
WN
iA
Rb
dz
UP
IR
TE
TE
TE
TE
TE
in
in
Lz
Lz
Lz
Lz
Lz
Lz
"}
(18,1,1) = {"
Lz
Lz
Lz
Lz
Lz
Lz
Lz
Lz
Lz
Lz
Lz
Lz
Lz
Lz
Lz
TE
TE
TE
Jg
TE
in
in
em
lE
lE
lE
yk
Di
wD
lE
lE
SI
Yc
lE
lE
lE
em
in
TE
TE
TE
in
in
Lz
Lz
Lz
Lz
Lz
Lz
Lz
"}
(19,1,1) = {"
Lz
Lz
Lz
Lz
Lz
Lz
Lz
Lz
Lz
Lz
Lz
Lz
Lz
Lz
Lz
TE
Ho
TE
TE
in
in
in
em
LI
Rb
fU
lE
Rb
tS
lE
Jn
Rb
Rb
Wz
nG
Xo
em
in
in
in
in
in
in
in
Lz
Lz
Lz
Lz
Lz
Lz
"}
(20,1,1) = {"
Lz
Lz
Lz
Lz
Lz
Lz
Lz
Lz
Lz
Lz
Lz
Lz
Lz
Lz
Lz
TE
TE
TE
TE
in
in
in
em
Rb
fD
Rb
kl
fD
Py
ik
Rb
Rb
Rb
fD
Rb
Rb
em
in
It
in
in
in
in
Lz
Lz
Lz
Lz
Lz
Lz
Lz
"}
(21,1,1) = {"
Lz
Lz
Lz
Lz
Lz
Lz
Lz
Lz
Lz
Lz
Lz
Lz
Lz
Lz
Lz
Lz
TE
TE
TE
in
in
in
em
LI
Tl
fU
lE
Rb
Rb
lE
CE
en
XN
Eg
hc
Wz
em
in
in
in
in
in
Lz
Lz
Lz
Lz
Lz
Lz
Lz
Lz
"}
(22,1,1) = {"
Lz
Lz
Lz
Lz
Lz
Lz
Lz
Lz
Lz
Lz
Lz
Lz
Lz
Lz
Lz
in
TE
in
in
in
It
in
em
lE
lE
lE
Nt
Rb
Rb
lE
lE
lE
lE
lE
lE
em
em
It
in
in
in
in
in
in
Lz
Lz
Lz
Lz
Lz
Lz
"}
(23,1,1) = {"
Lz
Lz
Lz
Lz
Lz
Lz
Lz
Lz
Lz
Lz
Lz
Lz
Lz
Lz
in
in
in
in
in
in
in
in
em
LI
Rb
bl
lE
Rb
fD
UZ
lE
FW
or
or
tu
em
It
It
in
in
in
in
in
Lz
Lz
Lz
Lz
Lz
Lz
Lz
"}
(24,1,1) = {"
Lz
Lz
Lz
Lz
Lz
Lz
Lz
Lz
Lz
Lz
Lz
Lz
Lz
Lz
in
in
in
in
in
in
in
in
em
Rb
Rb
fD
Xy
Rb
Rb
mx
lE
FW
dr
LB
Px
em
It
in
in
in
in
in
Lz
Lz
Lz
Lz
Lz
Lz
Lz
Lz
"}
(25,1,1) = {"
Lz
Lz
Lz
Lz
Lz
Lz
Lz
Lz
Lz
Lz
Lz
Lz
Lz
in
in
in
in
in
in
in
in
in
em
LI
MO
fU
lE
Rb
kS
OX
lE
FW
HP
DP
VE
bY
Lz
Lz
Lz
in
Lz
Lz
Lz
Lz
Lz
Lz
Lz
Lz
Lz
Lz
"}
(26,1,1) = {"
Lz
Lz
Lz
Lz
Lz
Lz
Lz
Lz
Lz
Lz
Lz
Lz
Lz
in
in
in
in
in
in
in
It
in
em
lE
lE
lE
op
Im
Rb
lE
lE
JT
Sp
Xr
HX
Xr
wF
Lz
Lz
Lz
Lz
Lz
Lz
Lz
Lz
Lz
Lz
Lz
Lz
Lz
"}
(27,1,1) = {"
Lz
Lz
Lz
Lz
Lz
Lz
Lz
Lz
Lz
Lz
Lz
Lz
in
in
in
in
in
in
in
in
in
in
em
ij
Pz
sw
lE
wD
Rb
lE
GD
or
DP
eI
wF
wF
wF
Lz
Lz
Lz
Lz
Lz
Lz
Lz
Lz
Lz
Lz
Lz
Lz
Lz
"}
(28,1,1) = {"
Lz
Lz
Lz
Lz
Lz
Lz
Lz
Lz
Lz
Lz
Lz
in
in
in
in
in
in
in
in
in
in
in
em
wj
Rb
Oz
fW
OT
Rb
sc
lQ
VE
VE
re
wF
Lz
Lz
Lz
Lz
Lz
Lz
Lz
Lz
Lz
Lz
Lz
Lz
Lz
Lz
Lz
"}
(29,1,1) = {"
Lz
Lz
Lz
Lz
Lz
Lz
Lz
Lz
Lz
Lz
Lz
in
in
in
in
in
in
in
in
in
in
in
em
CR
Cc
Pk
lE
Rb
Rb
lE
or
xG
Xr
VE
wF
Lz
wF
Lz
Lz
Lz
Lz
Lz
Lz
Lz
Lz
Lz
Lz
Lz
Lz
Lz
"}
(30,1,1) = {"
Lz
Lz
Lz
Lz
Lz
Lz
Lz
Lz
Lz
Lz
in
in
in
in
in
in
in
in
in
in
in
in
em
em
em
em
em
vf
JT
lE
em
em
HX
VE
wF
wF
Lz
Lz
Lz
Lz
Lz
Lz
Lz
Lz
Lz
Lz
Lz
Lz
Lz
Lz
"}
(31,1,1) = {"
Lz
Lz
Lz
Lz
Lz
Lz
Lz
Lz
Lz
Lz
in
in
in
in
in
in
in
in
in
in
in
in
in
in
em
At
Ur
Rb
Rb
hD
em
Lz
Lz
Lz
wF
Lz
Lz
Lz
Lz
Lz
Lz
Lz
Lz
Lz
Lz
Lz
Lz
Lz
Lz
Lz
"}
(32,1,1) = {"
Lz
Lz
Lz
Lz
Lz
Lz
Lz
Lz
Lz
Lz
Lz
in
in
in
in
in
in
in
in
in
kd
in
in
in
em
Rb
Rb
iY
xv
Ss
JT
Lz
Lz
wF
Lz
wF
wF
wF
Lz
Lz
Lz
Lz
Lz
Lz
Lz
Lz
Lz
Lz
Lz
Lz
"}
(33,1,1) = {"
Lz
Lz
Lz
Lz
Lz
Lz
Lz
Lz
Lz
Lz
Lz
in
in
in
in
in
in
in
in
in
in
in
in
in
em
Rb
Wk
Rb
Rb
qX
JT
Lz
wF
wF
Lz
wF
Lz
Lz
Lz
Lz
Lz
Lz
Lz
Lz
Lz
Lz
Lz
Lz
Lz
Lz
"}
(34,1,1) = {"
Lz
Lz
Lz
Lz
Lz
Lz
Lz
Lz
Lz
Lz
Lz
Lz
in
in
in
in
in
in
in
in
in
in
in
in
em
WH
WH
WH
hD
gW
JT
Lz
Lz
Lz
Lz
Lz
Lz
Lz
Lz
Lz
Lz
Lz
Lz
Lz
Lz
Lz
Lz
Lz
Lz
Lz
"}
(35,1,1) = {"
Lz
Lz
Lz
Lz
Lz
Lz
Lz
Lz
Lz
Lz
Lz
Lz
Lz
Lz
in
in
in
in
in
in
in
in
in
in
em
JT
JT
JT
JT
JT
JT
Lz
Lz
Lz
Lz
Lz
Lz
Lz
Lz
Lz
Lz
Lz
Lz
Lz
Lz
Lz
Lz
Lz
Lz
Lz
"}
(36,1,1) = {"
Lz
Lz
Lz
Lz
Lz
Lz
Lz
Lz
Lz
Lz
Lz
Lz
Lz
Lz
Lz
Lz
in
in
in
in
in
in
in
Lz
Lz
Lz
Lz
Lz
Lz
Lz
Lz
Lz
Lz
Lz
Lz
Lz
Lz
Lz
Lz
Lz
Lz
Lz
Lz
Lz
Lz
Lz
Lz
Lz
Lz
Lz
"}
(37,1,1) = {"
Lz
Lz
Lz
Lz
Lz
Lz
Lz
Lz
Lz
Lz
Lz
Lz
Lz
Lz
Lz
Lz
in
in
in
in
in
Lz
Lz
Lz
Lz
Lz
Lz
Lz
Lz
Lz
Lz
Lz
Lz
Lz
Lz
Lz
Lz
Lz
Lz
Lz
Lz
Lz
Lz
Lz
Lz
Lz
Lz
Lz
Lz
Lz
"}
(38,1,1) = {"
Lz
Lz
Lz
Lz
Lz
Lz
Lz
Lz
Lz
Lz
Lz
Lz
Lz
Lz
Lz
Lz
Lz
in
in
in
Lz
Lz
Lz
Lz
Lz
Lz
Lz
Lz
Lz
Lz
Lz
Lz
Lz
Lz
Lz
Lz
Lz
Lz
Lz
Lz
Lz
Lz
Lz
Lz
Lz
Lz
Lz
Lz
Lz
Lz
"}
(39,1,1) = {"
Lz
Lz
Lz
Lz
Lz
Lz
Lz
Lz
Lz
Lz
Lz
Lz
Lz
Lz
Lz
Lz
Lz
Lz
Lz
in
Lz
Lz
Lz
Lz
Lz
Lz
Lz
Lz
Lz
Lz
Lz
Lz
Lz
Lz
Lz
Lz
Lz
Lz
Lz
Lz
Lz
Lz
Lz
Lz
Lz
Lz
Lz
Lz
Lz
Lz
"}
(40,1,1) = {"
Lz
Lz
Lz
Lz
Lz
Lz
Lz
Lz
Lz
Lz
Lz
Lz
Lz
Lz
Lz
Lz
Lz
Lz
Lz
Lz
Lz
Lz
Lz
Lz
Lz
Lz
Lz
Lz
Lz
Lz
Lz
Lz
Lz
Lz
Lz
Lz
Lz
Lz
Lz
Lz
Lz
Lz
Lz
Lz
Lz
Lz
Lz
Lz
Lz
Lz
"}
(41,1,1) = {"
Lz
Lz
Lz
Lz
Lz
Lz
Lz
Lz
Lz
Lz
Lz
Lz
Lz
Lz
Lz
Lz
Lz
Lz
Lz
Lz
Lz
Lz
Lz
Lz
Lz
Lz
Lz
Lz
Lz
Lz
Lz
Lz
Lz
Lz
Lz
Lz
Lz
Lz
Lz
Lz
Lz
Lz
Lz
Lz
Lz
Lz
Lz
Lz
Lz
Lz
"}
(42,1,1) = {"
Lz
Lz
Lz
Lz
Lz
Lz
Lz
Lz
Lz
Lz
Lz
Lz
Lz
Lz
Lz
Lz
Lz
Lz
Lz
Lz
Lz
Lz
Lz
Lz
Lz
Lz
Lz
Lz
Lz
Lz
Lz
Lz
Lz
Lz
Lz
Lz
Lz
Lz
Lz
Lz
Lz
Lz
Lz
Lz
Lz
Lz
Lz
Lz
Lz
Lz
"}
(43,1,1) = {"
Lz
Lz
Lz
Lz
Lz
Lz
Lz
Lz
Lz
Lz
Lz
Lz
Lz
Lz
Lz
Lz
Lz
Lz
Lz
Lz
Lz
Lz
Lz
Lz
Lz
Lz
Lz
Lz
Lz
Lz
Lz
Lz
Lz
Lz
Lz
Lz
Lz
Lz
Lz
Lz
Lz
Lz
Lz
Lz
Lz
Lz
Lz
Lz
Lz
Lz
"}
(44,1,1) = {"
Lz
Lz
Lz
Lz
Lz
Lz
Lz
Lz
Lz
Lz
Lz
Lz
Lz
Lz
Lz
Lz
Lz
Lz
Lz
Lz
Lz
Lz
Lz
Lz
Lz
Lz
Lz
Lz
Lz
Lz
Lz
Lz
Lz
Lz
Lz
Lz
Lz
Lz
Lz
Lz
Lz
Lz
Lz
Lz
Lz
Lz
Lz
Lz
Lz
Lz
"}
(45,1,1) = {"
Lz
Lz
Lz
Lz
Lz
Lz
Lz
Lz
Lz
Lz
Lz
Lz
Lz
Lz
Lz
Lz
Lz
Lz
Lz
Lz
Lz
Lz
Lz
Lz
Lz
Lz
Lz
Lz
Lz
Lz
Lz
Lz
Lz
Lz
Lz
Lz
Lz
Lz
Lz
Lz
Lz
Lz
Lz
Lz
Lz
Lz
Lz
Lz
Lz
Lz
"}
(46,1,1) = {"
Lz
Lz
Lz
Lz
Lz
Lz
Lz
Lz
Lz
Lz
Lz
Lz
Lz
Lz
Lz
Lz
Lz
Lz
Lz
Lz
Lz
Lz
Lz
Lz
Lz
Lz
Lz
Lz
Lz
Lz
Lz
Lz
Lz
Lz
Lz
Lz
Lz
Lz
Lz
Lz
Lz
Lz
Lz
Lz
Lz
Lz
Lz
Lz
Lz
Lz
"}
(47,1,1) = {"
Lz
Lz
Lz
Lz
Lz
Lz
Lz
Lz
Lz
Lz
Lz
Lz
Lz
Lz
Lz
Lz
Lz
Lz
Lz
Lz
Lz
Lz
Lz
Lz
Lz
Lz
Lz
Lz
Lz
Lz
Lz
Lz
Lz
Lz
Lz
Lz
Lz
Lz
Lz
Lz
Lz
Lz
Lz
Lz
Lz
Lz
Lz
Lz
Lz
Lz
"}
(48,1,1) = {"
Lz
Lz
Lz
Lz
Lz
Lz
Lz
Lz
Lz
Lz
Lz
Lz
Lz
Lz
Lz
Lz
Lz
Lz
Lz
Lz
Lz
Lz
Lz
Lz
Lz
Lz
Lz
Lz
Lz
Lz
Lz
Lz
Lz
Lz
Lz
Lz
Lz
Lz
Lz
Lz
Lz
Lz
Lz
Lz
Lz
Lz
Lz
Lz
Lz
Lz
"}
(49,1,1) = {"
Lz
Lz
Lz
Lz
Lz
Lz
Lz
Lz
Lz
Lz
Lz
Lz
Lz
Lz
Lz
Lz
Lz
Lz
Lz
Lz
Lz
Lz
Lz
Lz
Lz
Lz
Lz
Lz
Lz
Lz
Lz
Lz
Lz
Lz
Lz
Lz
Lz
Lz
Lz
Lz
Lz
Lz
Lz
Lz
Lz
Lz
Lz
Lz
Lz
Lz
"}
(50,1,1) = {"
Lz
Lz
Lz
Lz
Lz
Lz
Lz
Lz
Lz
Lz
Lz
Lz
Lz
Lz
Lz
Lz
Lz
Lz
Lz
Lz
Lz
Lz
Lz
Lz
Lz
Lz
Lz
Lz
Lz
Lz
Lz
Lz
Lz
Lz
Lz
Lz
Lz
Lz
Lz
Lz
Lz
Lz
Lz
Lz
Lz
Lz
Lz
Lz
Lz
Lz
"}
