//MAP CONVERTED BY dmm2tgm.py THIS HEADER COMMENT PREVENTS RECONVERSION, DO NOT REMOVE
"aa" = (
/turf/open/space/basic,
/area/space)
"ab" = (
/obj/structure/cable{
	icon_state = "4-8"
	},
/turf/open/floor/carpet/nanoweave,
/area/ruin/space/has_grav/storage/materials3)
"ac" = (
/obj/structure/table,
/obj/item/flashlight/lamp,
/turf/open/floor/carpet/nanoweave,
/area/ruin/space/has_grav/storage/materials3)
"ad" = (
/obj/structure/chair/sofa{
	dir = 4
	},
/turf/open/floor/carpet/nanoweave,
/area/ruin/space/has_grav/storage/materials3)
"ae" = (
/turf/open/floor/carpet/nanoweave,
/area/ruin/space/has_grav/storage/materials3)
"af" = (
/obj/effect/decal/cleanable/blood/footprints{
	dir = 4;
	icon_state = "blood1"
	},
/turf/open/floor/iron,
/area/ruin/space/has_grav/storage/materials2)
"ag" = (
/obj/effect/decal/cleanable/blood/footprints{
	dir = 4;
	icon_state = "blood1"
	},
/obj/item/storage/pill_bottle/floorpill/full,
/turf/open/floor/iron,
/area/ruin/space/has_grav/storage/materials2)
"ah" = (
/turf/closed/mineral,
/area/ruin/space/has_grav)
"ai" = (
/obj/structure/table/reinforced/titaniumglass,
/obj/item/paper_bin,
/obj/item/pen,
/turf/open/floor/iron,
/area/ruin/space/has_grav/storage/central)
"ak" = (
/obj/effect/decal/cleanable/blood/footprints{
	dir = 1;
	icon_state = "blood1"
	},
/turf/open/floor/iron,
/area/ruin/space/has_grav/storage/materials2)
"al" = (
/obj/effect/decal/cleanable/blood/footprints{
	dir = 4;
	icon_state = "blood1"
	},
/obj/effect/decal/cleanable/dirt,
/turf/open/floor/iron,
/area/ruin/space/has_grav/storage/materials2)
"am" = (
/turf/open/floor/iron,
/area/ruin/space/has_grav/storage/materials2)
"an" = (
/obj/structure/closet/crate/secure/weapon,
/obj/item/ammo_box/magazine/co9mm,
/obj/item/ammo_box/magazine/co9mm,
/obj/item/ammo_box/magazine/co9mm,
/turf/open/floor/iron,
/area/ruin/space/has_grav/storage/materials2)
"ao" = (
/obj/effect/decal/cleanable/blood/footprints{
	dir = 4;
	icon_state = "blood1"
	},
/obj/effect/decal/cleanable/dirt/dust,
/turf/open/floor/iron,
/area/ruin/space/has_grav/storage/materials2)
"ap" = (
/obj/effect/decal/cleanable/cobweb,
/turf/open/floor/iron,
/area/ruin/space/has_grav/storage/materials1)
"aq" = (
/turf/open/floor/iron,
/area/ruin/space/has_grav/storage/materials1)
"au" = (
/obj/structure/table/reinforced/titaniumglass,
/obj/item/paper_bin,
/turf/open/floor/iron,
/area/ruin/space/has_grav/storage/central)
"av" = (
/obj/structure/falsewall/reinforced,
/obj/effect/decal/cleanable/blood/footprints{
	dir = 1;
	icon_state = "blood1"
	},
/turf/open/floor/iron,
/area/ruin/space/has_grav/storage/materials2)
"aw" = (
/obj/structure/closet/syndicate/resources{
	name = "Resource storage"
	},
/obj/effect/decal/cleanable/cobweb,
/turf/open/floor/iron,
/area/ruin/space/has_grav/storage/materials2)
"ax" = (
/obj/structure/closet/syndicate/resources{
	name = "Resource storage"
	},
/turf/open/floor/iron,
/area/ruin/space/has_grav/storage/materials2)
"ay" = (
/obj/machinery/jukebox,
/turf/open/floor/carpet/nanoweave,
/area/ruin/space/has_grav/storage/materials3)
"aA" = (
/obj/effect/decal/cleanable/blood/tracks{
	dir = 4;
	icon_state = "tracks"
	},
/turf/open/floor/iron,
/area/ruin/space/has_grav/storage/materials1)
"aB" = (
/obj/machinery/door/airlock/highsecurity,
/obj/effect/decal/cleanable/blood/tracks{
	dir = 4;
	icon_state = "tracks"
	},
/obj/effect/mapping_helpers/airlock/locked,
/turf/open/floor/iron,
/area/ruin/space/has_grav/storage/materials2)
"aC" = (
/obj/effect/decal/cleanable/blood,
/turf/open/floor/iron,
/area/ruin/space/has_grav/storage/materials2)
"aD" = (
/obj/machinery/door/airlock/highsecurity,
/obj/effect/mapping_helpers/airlock/locked,
/turf/open/floor/iron,
/area/ruin/space/has_grav/storage/materials2)
"aE" = (
/obj/item/bear_armor,
/turf/open/floor/iron,
/area/ruin/space/has_grav/storage/materials2)
"aH" = (
/obj/structure/closet/syndicate/resources{
	name = "Resource storage"
	},
/obj/effect/decal/cleanable/blood,
/turf/open/floor/iron,
/area/ruin/space/has_grav/storage/materials2)
"aI" = (
/obj/effect/spawner/lootdrop/glowstick,
/turf/open/floor/iron,
/area/ruin/space/has_grav/storage/materials1)
"aJ" = (
/obj/effect/decal/cleanable/cobweb,
/turf/open/floor/iron,
/area/ruin/space/has_grav/storage/materials2)
"aK" = (
/obj/structure/falsewall/reinforced,
/turf/open/floor/iron,
/area/ruin/space/has_grav/storage/materials2)
"aM" = (
/turf/closed/indestructible/reinforced,
/area/ruin/space/has_grav/storage/power1)
"aR" = (
/turf/closed/indestructible/reinforced,
/area/ruin/space/has_grav/storage/power2)
"aS" = (
/turf/closed/indestructible/reinforced,
/area/ruin/space/has_grav/storage/power3)
"aT" = (
/obj/effect/decal/cleanable/cobweb,
/turf/open/floor/iron,
/area/ruin/space/has_grav/storage/power3)
"aU" = (
/turf/open/floor/iron,
/area/ruin/space/has_grav/storage/power3)
"aV" = (
/obj/effect/decal/cleanable/cobweb,
/turf/open/floor/iron,
/area/ruin/space/has_grav/storage/power1)
"aW" = (
/obj/item/export_scanner,
/obj/effect/decal/cleanable/dirt/dust,
/obj/structure/cable{
	icon_state = "4-8"
	},
/turf/open/floor/iron,
/area/ruin/space/has_grav/storage/central)
"aX" = (
/turf/open/floor/iron,
/area/ruin/space/has_grav/storage/power1)
"aY" = (
/obj/structure/cable{
	icon_state = "2-4"
	},
/turf/open/floor/iron,
/area/ruin/space/has_grav/storage/power1)
"aZ" = (
/obj/item/stack/tile/carpet/nanoweave,
/turf/open/floor/plating,
/area/ruin/space/has_grav/storage/materials3)
"ba" = (
/obj/structure/closet/toolcloset,
/obj/effect/decal/cleanable/cobweb,
/turf/open/floor/iron,
/area/ruin/space/has_grav/storage/power2)
"bb" = (
/obj/structure/cable{
	icon_state = "1-4"
	},
/turf/open/floor/carpet/nanoweave,
/area/ruin/space/has_grav/storage/materials3)
"bc" = (
/obj/structure/closet/toolcloset,
/turf/open/floor/iron,
/area/ruin/space/has_grav/storage/power2)
"bd" = (
/obj/effect/decal/cleanable/blood/splatter,
/obj/effect/mob_spawn/human/corpse/cargo_tech,
/obj/item/weldingtool/mini,
/obj/structure/cable{
	icon_state = "2-8"
	},
/turf/open/floor/carpet/nanoweave,
/area/ruin/space/has_grav/storage/materials3)
"be" = (
/obj/effect/decal/cleanable/cobweb/cobweb2,
/turf/open/floor/iron,
/area/ruin/space/has_grav/storage/materials1)
"bf" = (
/obj/item/storage/pill_bottle,
/turf/open/floor/iron,
/area/ruin/space/has_grav/storage/materials2)
"bh" = (
/obj/effect/decal/cleanable/dirt/dust,
/turf/open/floor/iron,
/area/ruin/space/has_grav/storage/materials1)
"bi" = (
/turf/open/floor/iron,
/area/ruin/space/has_grav/storage/power2)
"bj" = (
/obj/machinery/vending/engivend,
/turf/open/floor/iron,
/area/ruin/space/has_grav/storage/power2)
"bk" = (
/turf/closed/indestructible/reinforced,
/area/ruin/space/has_grav/storage/central2)
"bl" = (
/obj/structure/closet/crate/engineering/electrical,
/turf/open/floor/iron,
/area/ruin/space/has_grav/storage/central)
"bm" = (
/obj/structure/falsewall/reinforced,
/obj/effect/decal/cleanable/blood/tracks,
/obj/structure/cable{
	icon_state = "1-2"
	},
/turf/open/floor/iron,
/area/ruin/space/has_grav/storage/central)
"bp" = (
/turf/open/floor/iron,
/area/ruin/space/has_grav/storage/central)
"bq" = (
/obj/structure/closet/firecloset/full,
/turf/open/floor/iron,
/area/ruin/space/has_grav/storage/central)
"br" = (
/obj/structure/closet/crate,
/obj/effect/spawner/lootdrop/maintenance/two,
/obj/effect/decal/cleanable/cobweb,
/obj/effect/spawner/lootdrop/minor/kittyears_or_rabbitears,
/turf/open/floor/iron,
/area/ruin/space/has_grav/storage/central)
"bs" = (
/obj/structure/closet/crate,
/obj/effect/spawner/lootdrop/maintenance/two,
/turf/open/floor/iron,
/area/ruin/space/has_grav/storage/central)
"bt" = (
/obj/effect/decal/cleanable/blood/tracks{
	dir = 10;
	icon_state = "tracks"
	},
/obj/structure/cable{
	icon_state = "1-4"
	},
/turf/open/floor/iron,
/area/ruin/space/has_grav/storage/central)
"bx" = (
/obj/structure/cable{
	icon_state = "1-4"
	},
/turf/closed/indestructible/reinforced,
/area/ruin/space/has_grav/storage/power2)
"by" = (
/obj/effect/decal/cleanable/cobweb/cobweb2,
/turf/open/floor/iron,
/area/ruin/space/has_grav/storage/central)
"bz" = (
/obj/structure/table/reinforced/titaniumglass,
/turf/open/floor/iron,
/area/ruin/space/has_grav/storage/central)
"bB" = (
/obj/vehicle/ridden/bicycle,
/turf/open/floor/iron,
/area/ruin/space/has_grav/storage/central2)
"bC" = (
/turf/open/floor/iron,
/area/ruin/space/has_grav/storage/central2)
"bD" = (
/obj/structure/table/wood/fancy/cyan,
/obj/item/storage/lockbox/dueling{
	req_access = null
	},
/turf/open/floor/iron,
/area/ruin/space/has_grav/storage/central2)
"bE" = (
/obj/structure/cable{
	icon_state = "4-8"
	},
/obj/effect/decal/cleanable/cobweb,
/turf/open/floor/iron,
/area/ruin/space/has_grav/storage/power2)
"bG" = (
/obj/structure/closet/crate/secure/loot,
/turf/open/floor/iron,
/area/ruin/space/has_grav/storage/power3)
"bH" = (
/obj/effect/mapping_helpers/airlock/locked,
/obj/machinery/door/airlock/vault/derelict,
/turf/open/floor/iron,
/area/ruin/space/has_grav/storage/central2)
"bL" = (
/obj/structure/chair/sofa/left{
	dir = 4
	},
/turf/open/floor/carpet/nanoweave,
/area/ruin/space/has_grav/storage/materials3)
"bQ" = (
/obj/effect/decal/cleanable/blood/footprints{
	dir = 8;
	icon_state = "blood1"
	},
/turf/open/floor/iron,
/area/ruin/space/has_grav/storage/power2)
"bS" = (
/obj/structure/table/wood/fancy/royalblue,
/obj/item/storage/box/hypospray{
	pixel_y = 4
	},
/turf/open/floor/iron,
/area/ruin/space/has_grav/storage/central2)
"bT" = (
/obj/effect/decal/cleanable/blood/tracks{
	dir = 4;
	icon_state = "tracks"
	},
/obj/effect/decal/cleanable/dirt/dust,
/turf/open/floor/iron,
/area/ruin/space/has_grav/storage/materials1)
"bX" = (
/obj/effect/decal/cleanable/dirt/dust,
/turf/open/floor/iron,
/area/ruin/space/has_grav/storage/materials2)
"bZ" = (
/obj/effect/decal/cleanable/dirt/dust,
/turf/closed/indestructible/reinforced,
/area/ruin/space/has_grav/storage/materials2)
"ca" = (
/obj/effect/mob_spawn/human/corpse/cargo_tech,
/turf/open/floor/iron,
/area/ruin/space/has_grav/storage/central)
"cc" = (
/obj/effect/decal/cleanable/blood/footprints{
	dir = 8;
	icon_state = "blood1"
	},
/obj/effect/mapping_helpers/airlock/locked,
/obj/machinery/door/airlock/engineering/glass{
	name = "Engineering"
	},
/turf/open/floor/iron,
/area/ruin/space/has_grav/storage/power2)
"cd" = (
/obj/structure/table/wood/fancy/red,
/obj/item/gun/ballistic/automatic/pistol/commander{
	pixel_y = 2
	},
/turf/open/floor/iron,
/area/ruin/space/has_grav/storage/central2)
"ce" = (
/obj/item/crowbar/red,
/turf/open/floor/iron,
/area/ruin/space/has_grav/storage/central)
"cg" = (
/obj/structure/closet/crate/internals,
/turf/open/floor/iron,
/area/ruin/space/has_grav/storage/central)
"ch" = (
/obj/effect/decal/cleanable/oil,
/turf/open/floor/iron,
/area/ruin/space/has_grav/storage/materials1)
"ci" = (
/obj/structure/closet/crate/secure/loot,
/turf/open/floor/iron,
/area/ruin/space/has_grav/storage/central)
"cj" = (
/obj/structure/table/wood/fancy/orange,
/obj/item/construction/rcd,
/turf/open/floor/iron,
/area/ruin/space/has_grav/storage/central2)
"ck" = (
/obj/structure/table/wood/fancy/green,
/obj/item/construction/rld,
/turf/open/floor/iron,
/area/ruin/space/has_grav/storage/central2)
"cl" = (
/obj/structure/table/wood/fancy/purple,
/obj/item/assembly/signaler/anomaly{
	pixel_y = 7
	},
/turf/open/floor/iron,
/area/ruin/space/has_grav/storage/central2)
"cm" = (
/obj/item/crowbar/red,
/obj/effect/mob_spawn/human/corpse/cargo_tech,
/turf/open/floor/iron,
/area/ruin/space/has_grav/storage/power2)
"cp" = (
/obj/structure/closet/crate/medical,
/obj/item/storage/pill_bottle/lsd,
/obj/item/storage/pill_bottle/happy,
/turf/open/floor/iron,
/area/ruin/space/has_grav/storage/power2)
"cq" = (
/obj/effect/decal/cleanable/dirt,
/turf/open/floor/iron,
/area/ruin/space/has_grav/storage/materials2)
"cr" = (
/obj/structure/falsewall/reinforced,
/obj/effect/decal/cleanable/dirt/dust,
/turf/open/floor/iron,
/area/ruin/space/has_grav/storage/materials2)
"cs" = (
/obj/item/storage/pill_bottle,
/turf/open/floor/iron,
/area/ruin/space/has_grav/storage/power2)
"ct" = (
/obj/structure/closet/cardboard/metal,
/obj/item/storage/toolbox/mechanical,
/obj/item/storage/toolbox/mechanical,
/obj/item/storage/toolbox/emergency,
/obj/item/storage/toolbox/electrical,
/obj/item/storage/toolbox/electrical,
/turf/open/floor/iron,
/area/ruin/space/has_grav/storage/power1)
"cu" = (
/obj/structure/closet/crate/solarpanel_small,
/turf/open/floor/iron,
/area/ruin/space/has_grav/storage/power2)
"cv" = (
/obj/structure/falsewall/reinforced,
/turf/open/floor/iron,
/area/ruin/space/has_grav/storage/power2)
"cw" = (
/obj/effect/decal/cleanable/dirt,
/obj/effect/decal/cleanable/dirt,
/turf/open/floor/iron,
/area/ruin/space/has_grav/storage/materials2)
"cx" = (
/obj/effect/decal/cleanable/dirt/dust,
/obj/effect/decal/cleanable/dirt,
/turf/open/floor/iron,
/area/ruin/space/has_grav/storage/materials2)
"cy" = (
/obj/effect/decal/cleanable/blood/tracks{
	dir = 8;
	icon_state = "tracks"
	},
/obj/effect/decal/cleanable/vomit,
/obj/structure/cable{
	icon_state = "4-8"
	},
/turf/open/floor/iron,
/area/ruin/space/has_grav/storage/central)
"cA" = (
/obj/effect/decal/cleanable/dirt/dust,
/turf/open/floor/iron,
/area/ruin/space/has_grav/storage/central)
"cB" = (
/obj/structure/closet/crate,
/obj/effect/spawner/lootdrop/maintenance/two,
/obj/effect/decal/cleanable/generic,
/turf/open/floor/iron,
/area/ruin/space/has_grav/storage/central)
"cD" = (
/obj/effect/spawner/lootdrop/glowstick,
/obj/effect/decal/cleanable/glass,
/turf/open/floor/iron,
/area/ruin/space/has_grav/storage/central)
"cE" = (
/obj/effect/decal/cleanable/dirt/dust,
/obj/effect/decal/cleanable/dirt/dust,
/turf/open/floor/iron,
/area/ruin/space/has_grav/storage/central)
"cH" = (
/obj/item/inducer,
/obj/effect/decal/cleanable/dirt,
/turf/open/floor/iron,
/area/ruin/space/has_grav/storage/central)
"cI" = (
/obj/effect/decal/cleanable/dirt,
/obj/effect/decal/cleanable/vomit,
/turf/open/floor/iron,
/area/ruin/space/has_grav/storage/central)
"cJ" = (
/obj/effect/decal/cleanable/dirt,
/turf/open/floor/iron,
/area/ruin/space/has_grav/storage/central)
"cM" = (
/obj/effect/decal/cleanable/oil,
/turf/open/floor/iron,
/area/ruin/space/has_grav/storage/central)
"cN" = (
/obj/effect/decal/cleanable/generic,
/turf/open/floor/iron,
/area/ruin/space/has_grav/storage/central)
"cO" = (
/obj/machinery/power/apc/auto_name/west{
	pixel_x = -24;
	start_charge = 0
	},
/obj/structure/cable{
	icon_state = "0-4"
	},
/obj/structure/chair/sofa/right{
	dir = 4
	},
/turf/open/floor/carpet/nanoweave,
/area/ruin/space/has_grav/storage/materials3)
"cP" = (
/obj/effect/decal/cleanable/vomit,
/turf/open/floor/iron,
/area/ruin/space/has_grav/storage/power2)
"cQ" = (
/obj/effect/decal/cleanable/dirt,
/turf/open/floor/iron,
/area/ruin/space/has_grav/storage/power2)
"cR" = (
/obj/structure/chair/office/light,
/turf/open/floor/iron,
/area/ruin/space/has_grav/storage/central)
"cS" = (
/obj/machinery/power/port_gen/pacman/uranium,
/obj/structure/cable,
/obj/effect/decal/cleanable/dirt,
/turf/open/floor/iron,
/area/ruin/space/has_grav/storage/power2)
"cT" = (
/obj/structure/table,
/turf/open/floor/carpet/nanoweave,
/area/ruin/space/has_grav/storage/materials3)
"cU" = (
/obj/structure/closet/crate,
/obj/item/bedsheet/ian,
/obj/item/bedsheet/dorms,
/obj/item/bedsheet/nanotrasen,
/obj/item/bedsheet/centcom,
/obj/item/bedsheet/syndie,
/obj/item/toy/plush/moth,
/turf/open/floor/iron,
/area/ruin/space/has_grav/storage/power1)
"cV" = (
/obj/effect/decal/cleanable/oil,
/turf/open/floor/iron,
/area/ruin/space/has_grav/storage/power1)
"cW" = (
/obj/effect/decal/cleanable/oil,
/turf/open/floor/iron,
/area/ruin/space/has_grav/storage/power2)
"dV" = (
/obj/structure/chair/office/light{
	dir = 8
	},
/turf/open/floor/iron,
/area/ruin/space/has_grav/storage/central)
"fd" = (
/obj/structure/cable{
	icon_state = "4-8"
	},
/turf/open/floor/iron,
/area/ruin/space/has_grav/storage/central)
"fo" = (
/obj/effect/mob_spawn/human/corpse/cargo_tech,
/turf/open/floor/carpet/nanoweave,
/area/ruin/space/has_grav/storage/materials3)
"gD" = (
/obj/machinery/power/apc/auto_name/north{
	pixel_y = 24;
	start_charge = 0
	},
/obj/effect/decal/cleanable/ash,
/obj/structure/cable{
	icon_state = "0-8"
	},
/turf/open/floor/iron,
/area/ruin/space/has_grav/storage/materials1)
"gG" = (
/obj/machinery/power/apc/auto_name/west{
	pixel_x = -24;
	start_charge = 0
	},
/obj/structure/cable{
	icon_state = "0-2"
	},
/turf/open/floor/iron,
/area/ruin/space/has_grav/storage/power3)
"gS" = (
/obj/effect/decal/cleanable/blood/footprints{
	dir = 1;
	icon_state = "blood1"
	},
/obj/structure/cable{
	icon_state = "1-8"
	},
/obj/structure/cable{
	icon_state = "1-2"
	},
/turf/open/floor/iron,
/area/ruin/space/has_grav/storage/central)
"hH" = (
/obj/effect/decal/cleanable/blood/footprints{
	dir = 1;
	icon_state = "blood1"
	},
/turf/open/floor/iron,
/area/ruin/space/has_grav/storage/power1)
"ku" = (
/obj/effect/mapping_helpers/airlock/locked,
/obj/structure/cable{
	icon_state = "0-4"
	},
/obj/machinery/door/airlock/glass{
	name = "Lounge"
	},
/turf/open/floor/iron,
/area/ruin/space/has_grav/storage/power3)
"kv" = (
/obj/structure/cable{
	icon_state = "2-8"
	},
/obj/structure/cable{
	icon_state = "2-4"
	},
/obj/structure/cable{
	icon_state = "4-8"
	},
/turf/closed/indestructible/reinforced,
/area/ruin/space/has_grav/storage/power2)
"kA" = (
/obj/structure/cable{
	icon_state = "4-8"
	},
/turf/open/floor/iron,
/area/ruin/space/has_grav/storage/materials1)
"kD" = (
/obj/machinery/door/airlock/highsecurity,
/obj/effect/decal/cleanable/blood/tracks,
/obj/effect/decal/cleanable/blood/tracks,
/obj/effect/mapping_helpers/airlock/locked,
/obj/structure/cable{
	icon_state = "1-2"
	},
/turf/open/floor/iron,
/area/ruin/space/has_grav/storage/materials1)
"lG" = (
/obj/machinery/power/apc/auto_name/east{
	pixel_x = 24;
	start_charge = 0
	},
/obj/effect/decal/cleanable/vomit,
/obj/structure/cable{
	icon_state = "0-8"
	},
/turf/open/floor/iron,
/area/ruin/space/has_grav/storage/materials2)
"mg" = (
/obj/structure/cable{
	icon_state = "1-2"
	},
/turf/open/floor/iron,
/area/ruin/space/has_grav/storage/central)
"mF" = (
/obj/machinery/power/apc/auto_name/east{
	pixel_x = 24;
	start_charge = 0
	},
/obj/structure/cable{
	icon_state = "0-2"
	},
/turf/open/floor/iron,
/area/ruin/space/has_grav/storage/central)
"mI" = (
/obj/structure/cable{
	icon_state = "1-4"
	},
/obj/structure/cable{
	icon_state = "4-8"
	},
/turf/open/floor/iron,
/area/ruin/space/has_grav/storage/power1)
"ob" = (
/turf/closed/indestructible/reinforced,
/area/ruin/space/has_grav/storage/materials3)
"oo" = (
/obj/structure/cable{
	icon_state = "2-8"
	},
/obj/structure/table,
/turf/open/floor/carpet/nanoweave,
/area/ruin/space/has_grav/storage/materials3)
"oT" = (
/obj/machinery/door/airlock/external,
/turf/open/floor/iron,
/area/ruin/space/has_grav/storage/central)
"rc" = (
/obj/effect/decal/cleanable/blood/tracks,
/obj/structure/cable{
	icon_state = "1-2"
	},
/turf/open/floor/iron,
/area/ruin/space/has_grav/storage/materials1)
"rf" = (
/turf/open/floor/plating,
/area/ruin/space/has_grav/storage/central)
"sH" = (
/obj/structure/table,
/obj/item/storage/pill_bottle/lsd,
/turf/open/floor/carpet/nanoweave,
/area/ruin/space/has_grav/storage/materials3)
"up" = (
/obj/structure/cable{
	icon_state = "4-8"
	},
/turf/closed/indestructible/reinforced,
/area/ruin/space/has_grav/storage/power2)
"uu" = (
/obj/structure/filingcabinet,
/obj/item/keycard{
	puzzle_id = "vaultcrew";
	name = "service keycard"
	},
/turf/open/floor/iron,
/area/ruin/space/has_grav/storage/central)
"uX" = (
/obj/machinery/door/airlock/highsecurity,
/obj/effect/decal/cleanable/blood/tracks,
/obj/effect/mapping_helpers/airlock/locked,
/obj/structure/cable{
	icon_state = "1-2"
	},
/turf/open/floor/iron,
/area/ruin/space/has_grav/storage/materials1)
"vE" = (
/obj/effect/decal/cleanable/blood/tracks{
	dir = 6;
	icon_state = "tracks"
	},
/obj/structure/cable{
	icon_state = "2-4"
	},
/obj/structure/cable{
	icon_state = "1-2"
	},
/obj/structure/cable{
	icon_state = "2-8"
	},
/turf/open/floor/iron,
/area/ruin/space/has_grav/storage/central)
"vJ" = (
/obj/structure/cable{
	icon_state = "1-2"
	},
/obj/structure/cable{
	icon_state = "1-8"
	},
/turf/open/floor/iron,
/area/ruin/space/has_grav/storage/power1)
"ws" = (
/obj/effect/decal/cleanable/dirt,
/obj/structure/cable{
	icon_state = "1-4"
	},
/turf/open/floor/iron,
/area/ruin/space/has_grav/storage/central)
"ww" = (
/obj/effect/decal/cleanable/blood/footprints{
	dir = 1;
	icon_state = "blood1"
	},
/obj/structure/cable{
	icon_state = "4-8"
	},
/turf/open/floor/iron,
/area/ruin/space/has_grav/storage/power1)
"xi" = (
/obj/machinery/power/smes,
/obj/structure/cable{
	icon_state = "0-8"
	},
/turf/open/floor/iron,
/area/ruin/space/has_grav/storage/power2)
"xl" = (
/turf/closed/indestructible/reinforced,
/area/ruin/space/has_grav/storage/central)
"ye" = (
/mob/living/simple_animal/hostile/carp/megacarp{
	desc = "A ferocious, fang bearing creature that resembles a shark. You get the feeling his name would be George."
	},
/turf/open/space/basic,
/area/space)
"Af" = (
/obj/structure/cable{
	icon_state = "2-8"
	},
/turf/closed/indestructible/reinforced,
/area/ruin/space/has_grav/storage/central2)
"Ao" = (
/obj/effect/decal/cleanable/ash,
/obj/structure/cable{
	icon_state = "4-8"
	},
/turf/open/floor/iron,
/area/ruin/space/has_grav/storage/central)
"Bq" = (
/obj/structure/cable{
	icon_state = "1-2"
	},
/turf/closed/indestructible/reinforced,
/area/ruin/space/has_grav/storage/central2)
"CD" = (
/obj/effect/decal/cleanable/glass,
/obj/structure/cable{
	icon_state = "1-2"
	},
/turf/open/floor/iron,
/area/ruin/space/has_grav/storage/central)
"CT" = (
/obj/effect/decal/cleanable/greenglow,
/turf/open/floor/iron,
/area/ruin/space/has_grav/storage/central)
"ES" = (
/obj/structure/table/reinforced/titaniumglass,
/obj/item/paper{
	info = "Josh. I know this job is boring and all, but I know a place we can all hang out. I broke a wall on accident while on the late shift a few days ago. It's in the northern wall. Just keep tapping walls until one opens. See you in that sick party bro. - Damien"
	},
/obj/item/pen,
/turf/open/floor/iron,
/area/ruin/space/has_grav/storage/central)
"Im" = (
/obj/machinery/door/airlock/highsecurity,
/obj/effect/mapping_helpers/airlock/locked,
/obj/structure/cable{
	icon_state = "4-8"
	},
/turf/open/floor/iron,
/area/ruin/space/has_grav/storage/central)
"In" = (
/obj/machinery/power/apc/auto_name/south{
	pixel_y = -24;
	start_charge = 0
	},
/obj/structure/cable{
	icon_state = "0-4"
	},
/turf/open/floor/iron,
/area/ruin/space/has_grav/storage/central2)
"Ir" = (
/obj/structure/cable{
	icon_state = "0-2"
	},
/obj/machinery/power/terminal{
	dir = 1
	},
/turf/open/floor/iron,
/area/ruin/space/has_grav/storage/power2)
"Js" = (
/obj/effect/decal/cleanable/blood/footprints{
	dir = 8;
	icon_state = "blood1"
	},
/turf/open/floor/iron,
/area/ruin/space/has_grav/storage/power1)
"JO" = (
/turf/closed/indestructible/reinforced,
/area/ruin/space/has_grav/storage/materials2)
"KY" = (
/obj/structure/cable{
	icon_state = "1-2"
	},
/turf/open/floor/iron,
/area/ruin/space/has_grav/storage/power1)
"LV" = (
/turf/closed/indestructible/reinforced,
/area/ruin/space/has_grav/storage/materials1)
"Mg" = (
/obj/structure/cable{
	icon_state = "2-4"
	},
/turf/open/floor/iron,
/area/ruin/space/has_grav/storage/materials1)
"Mh" = (
/obj/machinery/power/apc/auto_name/south{
	pixel_y = -24;
	start_charge = 0
	},
/obj/structure/cable{
	icon_state = "0-4"
	},
/obj/structure/table/reinforced/titaniumglass,
/turf/open/floor/iron,
/area/ruin/space/has_grav/storage/power1)
"Mm" = (
/obj/effect/decal/cleanable/blood/footprints{
	dir = 8;
	icon_state = "blood1"
	},
/obj/structure/cable{
	icon_state = "1-8"
	},
/turf/open/floor/iron,
/area/ruin/space/has_grav/storage/power1)
"OO" = (
/obj/effect/decal/cleanable/blood/footprints{
	dir = 1;
	icon_state = "blood1"
	},
/obj/structure/cable{
	icon_state = "1-4"
	},
/obj/machinery/door/keycard{
	puzzle_id = "vaultcrew"
	},
/turf/open/floor/iron,
/area/ruin/space/has_grav/storage/power1)
"Pi" = (
/obj/item/paper{
	info = "Damien, the room is sick, but we need more supplies to fix it up. I'll give you a key to the lower part of the outpost. Give it back when you're done. It's in my filing cabinet."
	},
/turf/open/floor/carpet/nanoweave,
/area/ruin/space/has_grav/storage/materials3)
"PF" = (
/obj/effect/decal/cleanable/blood/tracks{
	dir = 9;
	icon_state = "tracks"
	},
/obj/effect/decal/cleanable/dirt/dust,
/obj/effect/decal/cleanable/dirt/dust,
/obj/structure/cable{
	icon_state = "1-2"
	},
/turf/open/floor/iron,
/area/ruin/space/has_grav/storage/materials1)
"PU" = (
/obj/effect/decal/cleanable/dirt/dust,
/obj/structure/cable{
	icon_state = "1-2"
	},
/turf/open/floor/iron,
/area/ruin/space/has_grav/storage/central)
"RB" = (
/obj/structure/cable{
	icon_state = "1-8"
	},
/obj/structure/cable{
	icon_state = "1-2"
	},
/obj/structure/cable{
	icon_state = "2-8"
	},
/turf/open/floor/iron,
/area/ruin/space/has_grav/storage/central)
"SU" = (
/obj/machinery/computer/security/wooden_tv,
/turf/open/floor/carpet/nanoweave,
/area/ruin/space/has_grav/storage/materials3)
"SY" = (
/obj/machinery/power/apc/auto_name/east{
	pixel_x = 24;
	start_charge = 0
	},
/obj/structure/cable,
/turf/open/floor/iron,
/area/ruin/space/has_grav/storage/power2)
"Vs" = (
/obj/structure/cable{
	icon_state = "4-8"
	},
/obj/structure/cable{
	icon_state = "2-4"
	},
/obj/structure/cable{
	icon_state = "2-8"
	},
/turf/closed/indestructible/reinforced,
/area/ruin/space/has_grav/storage/central)
"VV" = (
/obj/machinery/door/airlock/external,
/turf/open/floor/plating,
/area/ruin/space/has_grav/storage/central)
"VX" = (
/obj/structure/cable{
	icon_state = "4-8"
	},
/turf/closed/indestructible/reinforced,
/area/ruin/space/has_grav/storage/central)
"Zz" = (
/obj/structure/cable{
	icon_state = "1-8"
	},
/turf/closed/indestructible/reinforced,
/area/ruin/space/has_grav/storage/power2)

(1,1,1) = {"
aa
aa
aa
aa
aa
aa
aa
aa
aa
aa
aa
aa
aa
ah
ah
xl
VV
xl
ah
ah
ah
aa
aa
aa
aa
aa
aa
aa
aa
aa
"}
(2,1,1) = {"
aa
aa
aa
aa
aa
aa
aa
aa
aa
aa
aa
aa
ah
ah
ah
xl
rf
xl
ah
ah
ah
ah
ah
aa
aa
ye
aa
aa
aa
aa
"}
(3,1,1) = {"
aa
aa
aa
aa
aa
aa
aa
aa
aa
aa
aa
ah
xl
xl
xl
xl
oT
xl
xl
xl
xl
ah
ah
aa
aa
aa
aa
aa
aa
aa
"}
(4,1,1) = {"
aa
aa
aa
aa
aa
ah
ah
aa
aa
ah
ah
ah
xl
bp
bp
bp
bp
bp
bp
bp
xl
ah
ah
ah
aa
aa
aa
aa
aa
aa
"}
(5,1,1) = {"
aa
aa
ah
ah
ah
ah
ah
ah
ah
ah
ah
ah
xl
bp
bp
bp
cH
cJ
bp
cg
xl
ah
ah
ah
ah
ah
ah
aa
aa
aa
"}
(6,1,1) = {"
aa
aa
ah
ah
ah
ah
ah
ah
ah
ah
ah
ah
xl
bq
bp
cD
cI
cJ
cg
bp
xl
ah
ah
ah
ah
ah
ah
ah
aa
aa
"}
(7,1,1) = {"
aa
aa
aa
ah
ob
ob
ob
ob
ob
ob
ob
ob
xl
bq
bp
mF
ws
cJ
cA
bp
xl
aS
aS
aS
aS
aS
aS
ah
ah
aa
"}
(8,1,1) = {"
aa
aa
aa
ah
ob
ae
aZ
ac
bL
ad
cO
sH
xl
xl
xl
xl
Im
xl
xl
xl
xl
aT
bG
aU
aU
aU
aS
ah
ah
aa
"}
(9,1,1) = {"
aa
aa
ah
ah
ob
aZ
ae
ae
fo
ae
ab
aZ
xl
br
bp
bp
fd
bp
bp
bl
xl
aU
aU
aU
aU
bG
aS
ah
ah
aa
"}
(10,1,1) = {"
aa
ah
ah
ah
ob
Pi
ay
aZ
cT
SU
oo
bb
xl
bs
bp
bp
fd
cN
cN
au
xl
aU
aU
aU
aU
aU
aS
ah
ah
aa
"}
(11,1,1) = {"
aa
aa
ah
ah
LV
LV
LV
LV
LV
LV
LV
bd
bm
bt
cB
cE
aW
bp
cR
ES
xl
aS
aS
ku
aS
aS
aS
ah
aa
aa
"}
(12,1,1) = {"
aa
aa
ah
ah
LV
ap
aq
bh
aq
aq
LV
LV
LV
cy
bp
bp
Ao
bp
cD
Mh
aM
aV
gG
mI
cU
aX
aM
ah
ah
aa
"}
(13,1,1) = {"
aa
aa
ah
ah
LV
aq
Mg
PF
rc
rc
uX
rc
kD
vE
CD
PU
RB
PU
mg
gS
OO
hH
hH
ww
cV
aX
aM
ah
ah
ah
"}
(14,1,1) = {"
aa
aa
ah
ah
LV
aq
kA
bT
ch
aI
LV
aq
LV
gD
CT
bp
ca
cN
cM
bz
VX
aY
KY
Mm
aX
aX
aM
ah
ah
ah
"}
(15,1,1) = {"
aa
aa
ah
ah
LV
aq
lG
aA
aq
aq
LV
be
xl
cA
bp
cB
bp
ce
dV
bz
Vs
vJ
SY
Js
aX
ct
aM
ah
ah
aa
"}
(16,1,1) = {"
aa
ah
ah
JO
JO
JO
JO
aB
JO
bZ
JO
JO
xl
bp
bs
bp
cM
bp
ci
ai
VX
aR
aR
cc
aR
aR
aR
ah
ah
aa
"}
(17,1,1) = {"
aa
ah
ah
JO
af
ak
av
aC
JO
aJ
am
bf
xl
by
bp
bp
bp
ci
bp
uu
VX
ba
bi
bQ
bi
bi
aR
ah
aa
aa
"}
(18,1,1) = {"
aa
ah
ah
JO
al
am
JO
am
JO
am
am
bf
bk
bk
bk
bk
bH
bk
bk
bk
up
bc
bi
bQ
cQ
cu
aR
ah
ah
aa
"}
(19,1,1) = {"
aa
ah
ah
JO
af
JO
JO
aD
JO
cr
bZ
cq
bk
bk
bk
bk
bC
bk
bk
bk
up
bi
cP
bQ
bi
cu
aR
ah
aa
aa
"}
(20,1,1) = {"
aa
ah
ah
JO
af
JO
aw
bX
aH
aK
JO
cw
bk
bk
bk
bk
bH
bk
bk
bk
up
bi
cQ
cm
cs
cu
aR
ah
ah
aa
"}
(21,1,1) = {"
aa
ah
ah
JO
ao
JO
am
am
ax
JO
JO
cx
bk
bk
bB
bC
bC
bC
cj
bk
up
bj
bi
cp
cW
bi
aR
ah
ah
aa
"}
(22,1,1) = {"
ah
ah
ah
JO
af
JO
ax
am
am
JO
JO
am
bk
bk
bC
bC
bC
bC
bC
bk
kv
bx
aR
aR
aR
cv
aR
ah
ah
aa
"}
(23,1,1) = {"
aa
ah
ah
JO
af
JO
JO
bZ
JO
JO
JO
am
bk
bk
bD
bC
bC
bC
ck
bk
up
bE
bi
cQ
cQ
cQ
aR
ah
ah
aa
"}
(24,1,1) = {"
aa
ah
ah
JO
ag
JO
am
aE
am
am
aK
am
bk
bk
bC
bC
bC
bC
bC
bk
up
xi
Ir
cS
cQ
cQ
aR
ah
ah
aa
"}
(25,1,1) = {"
aa
ah
ah
JO
an
JO
am
am
cq
cq
JO
In
bk
bk
bS
bC
cd
bC
cl
bk
up
aR
aR
aR
aR
aR
aR
ah
ah
aa
"}
(26,1,1) = {"
aa
ah
ah
JO
JO
JO
JO
JO
JO
JO
JO
Af
Bq
Bq
Bq
Bq
Bq
Bq
Bq
Bq
Zz
ah
ah
ah
ah
ah
ah
ah
ah
aa
"}
(27,1,1) = {"
aa
ah
ah
ah
ah
ah
ah
ah
ah
ah
ah
ah
bk
bk
bk
bk
bk
bk
bk
bk
aR
ah
ah
aa
ah
ah
ah
aa
aa
aa
"}
(28,1,1) = {"
aa
aa
ah
ah
ah
ah
ah
ah
ah
ah
ah
ah
ah
ah
ah
ah
ah
ah
ah
ah
ah
ah
ah
aa
aa
aa
aa
aa
aa
aa
"}
(29,1,1) = {"
aa
aa
aa
aa
aa
aa
aa
aa
aa
aa
aa
ah
ah
ah
ah
ah
ah
ah
ah
ah
aa
aa
aa
aa
aa
aa
aa
aa
aa
aa
"}
(30,1,1) = {"
aa
aa
aa
aa
aa
aa
aa
aa
aa
aa
aa
aa
aa
aa
ah
ah
ah
ah
aa
aa
aa
aa
aa
aa
aa
aa
aa
aa
aa
aa
"}
