"aa" = (/turf/open/space/basic,/area/space)
"ab" = (/turf/closed/mineral,/area/ruin/space/has_grav)
"ac" = (/obj/effect/decal/cleanable/vomit,/turf/open/floor/plating,/area/ruin/space/has_grav/scav_mining/dorm)
"ae" = (/mob/living/simple_animal/hostile/asteroid/hivelord,/turf/open/floor/plating/asteroid/airless,/area/ruin/space/has_grav)
"af" = (/obj/item/stack/medical/bruise_pack,/turf/open/floor/plating/asteroid/airless,/area/ruin/space/has_grav)
"ag" = (/obj/item/stack/ore/gold{amount = 2; pixel_x = 13},/turf/open/floor/plating/asteroid/airless,/area/ruin/space/has_grav)
"ak" = (/obj/machinery/door/airlock/hatch,/obj/machinery/atmospherics/pipe/simple{dir = 4},/turf/open/floor/plating/airless,/area/ruin/space/has_grav/scav_mining/entrance)
"al" = (/obj/item/stack/ore/titanium,/turf/open/floor/plating/asteroid/airless,/area/ruin/space/has_grav)
"au" = (/turf/open/floor/plating/asteroid/airless,/area/ruin/space/has_grav)
"ay" = (/obj/item/mining_scanner,/turf/open/floor/plating/asteroid/airless,/area/ruin/space/has_grav)
"aD" = (/obj/item/pickaxe/drill,/turf/open/floor/plating/asteroid/airless,/area/ruin/space/has_grav)
"aM" = (/obj/effect/decal/cleanable/ash,/turf/open/floor/plating/airless,/area/ruin/space/has_grav/scav_mining/entrance)
"aO" = (/obj/machinery/portable_atmospherics/pump,/obj/machinery/atmospherics/pipe/manifold/general{dir = 1},/turf/open/floor/plating,/area/ruin/space/has_grav/scav_mining/core)
"aQ" = (/turf/closed/mineral/random,/area/ruin/space/has_grav)
"aS" = (/obj/structure/cable{icon_state = "1-2"},/obj/machinery/atmospherics/pipe/simple,/turf/open/floor/plating,/area/ruin/space/has_grav/scav_mining/core)
"aU" = (/obj/item/stack/ore/plasma{amount = 10; pixel_x = -10; pixel_y = -10},/turf/open/floor/plating/asteroid/airless,/area/ruin/space/has_grav)
"aW" = (/obj/item/stack/ore/diamond{pixel_x = 5; pixel_y = 10},/turf/open/floor/plating/asteroid/airless,/area/ruin/space/has_grav)
"ba" = (/obj/structure/cable{icon_state = "1-2"},/turf/open/floor/plating/airless,/area/ruin/space/has_grav/scav_mining/entrance)
"bu" = (/obj/item/flashlight/lantern,/turf/open/floor/plating/asteroid/airless,/area/ruin/space/has_grav)
"cp" = (/obj/effect/decal/cleanable/dirt/dust,/obj/effect/decal/cleanable/ash,/turf/open/floor/plating/airless,/area/ruin/space/has_grav/scav_mining/entrance)
"cq" = (/obj/machinery/atmospherics/pipe/simple{dir = 9},/turf/open/floor/plating,/area/ruin/space/has_grav/scav_mining/core)
"cs" = (/obj/machinery/airalarm/directional/west{pixel_x = -24},/turf/open/floor/plating,/area/ruin/space/has_grav/scav_mining/dorm)
"dK" = (/obj/item/stack/sheet/mineral/wood,/turf/open/floor/plating,/area/ruin/space/has_grav/scav_mining/dorm)
"ez" = (/obj/structure/barricade/wooden,/turf/open/floor/plating,/area/ruin/space/has_grav/scav_mining/dorm)
"fB" = (/obj/effect/decal/cleanable/oil/streak,/obj/effect/decal/cleanable/dirt/dust,/obj/machinery/atmospherics/pipe/manifold/general,/turf/open/floor/plating,/area/ruin/space/has_grav/scav_mining/core)
"ga" = (/obj/machinery/atmospherics/components/unary/vent_pump{dir = 8},/turf/open/floor/plating/airless,/area/ruin/space/has_grav/scav_mining/entrance)
"gi" = (/obj/machinery/atmospherics/pipe/simple{dir = 9},/obj/item/stack/sheet/mineral/wood,/turf/open/floor/plating,/area/ruin/space/has_grav/scav_mining/core)
"gx" = (/turf/closed/wall,/area/ruin/space/has_grav/scav_mining/entrance)
"gR" = (/obj/item/reagent_containers/food/drinks/waterbottle/large/empty,/turf/open/floor/plating,/area/ruin/space/has_grav/scav_mining/dorm)
"hl" = (/obj/effect/decal/cleanable/dirt/dust,/obj/structure/cable{icon_state = "1-2"},/obj/machinery/atmospherics/components/unary/vent_pump{dir = 4},/turf/open/floor/plating/airless,/area/ruin/space/has_grav/scav_mining/entrance)
"hU" = (/obj/effect/decal/cleanable/ash,/turf/open/floor/plating,/area/ruin/space/has_grav/scav_mining/dorm)
"kW" = (/obj/item/stack/sheet/metal,/turf/open/floor/plating,/area/ruin/space/has_grav/scav_mining/dorm)
"lr" = (/obj/item/trash/boritos,/obj/effect/decal/cleanable/vomit,/turf/open/floor/plating,/area/ruin/space/has_grav/scav_mining/dorm)
"mS" = (/obj/effect/decal/cleanable/dirt/dust,/obj/machinery/portable_atmospherics/pump,/turf/open/floor/plating/asteroid/airless,/area/ruin/space/has_grav)
"nd" = (/obj/machinery/door/airlock/hatch,/turf/open/floor/plating/airless,/area/ruin/space/has_grav/scav_mining/entrance)
"nw" = (/obj/structure/table,/obj/machinery/light/small/broken{dir = 8},/turf/open/floor/plating,/area/ruin/space/has_grav/scav_mining/dorm)
"nA" = (/obj/item/trash/energybar,/turf/open/floor/plating,/area/ruin/space/has_grav/scav_mining/dorm)
"nE" = (/obj/structure/cable{icon_state = "1-2"},/obj/machinery/atmospherics/pipe/simple,/turf/open/floor/plating/airless,/area/ruin/space/has_grav/scav_mining/entrance)
"on" = (/obj/item/stack/ore/plasma{amount = 5; pixel_x = -15; pixel_y = -10},/turf/open/floor/plating/asteroid/airless,/area/ruin/space/has_grav)
"oB" = (/obj/item/grenade,/turf/open/floor/plating/asteroid/airless,/area/ruin/space/has_grav)
"pn" = (/mob/living/simple_animal/hostile/carp,/turf/open/space/basic,/area/space)
"pw" = (/obj/machinery/light/small/broken{dir = 1},/turf/open/floor/plating/airless,/area/ruin/space/has_grav/scav_mining/entrance)
"pA" = (/obj/machinery/atmospherics/components/unary/vent_pump{dir = 8},/turf/open/floor/plating,/area/ruin/space/has_grav/scav_mining/dorm)
"pE" = (/mob/living/simple_animal/hostile/asteroid/basilisk,/turf/open/floor/plating/airless,/area/ruin/space/has_grav/scav_mining/entrance)
"qb" = (/obj/effect/decal/cleanable/dirt/dust,/obj/machinery/atmospherics/pipe/simple{dir = 5},/turf/open/floor/plating/airless,/area/ruin/space/has_grav/scav_mining/entrance)
"qP" = (/turf/open/floor/plating,/area/ruin/space/has_grav/scav_mining/core)
"qX" = (/obj/item/stack/medical/ointment,/obj/item/pipe{dir = 5},/turf/open/floor/plating/asteroid/airless,/area/ruin/space/has_grav)
"rl" = (/obj/effect/mob_spawn/human/miner/explorer,/obj/effect/decal/cleanable/blood,/turf/open/floor/plating/asteroid/airless,/area/ruin/space/has_grav)
"rH" = (/obj/effect/decal/cleanable/dirt/dust,/turf/open/floor/plating/airless,/area/ruin/space/has_grav/scav_mining/entrance)
"rM" = (/obj/effect/mob_spawn/human/corpse/cargo_tech,/obj/structure/cable{icon_state = "4-8"},/obj/machinery/atmospherics/pipe/simple,/turf/open/floor/plating/airless,/area/ruin/space/has_grav/scav_mining/entrance)
"sr" = (/obj/machinery/atmospherics/pipe/simple{dir = 4},/turf/open/floor/plating,/area/ruin/space/has_grav/scav_mining/dorm)
"tr" = (/obj/item/stack/ore/silver{amount = 2; pixel_x = -16; pixel_y = -4},/turf/open/floor/plating/asteroid/airless,/area/ruin/space/has_grav)
"tw" = (/obj/item/stack/ore/uranium{pixel_x = -10},/turf/open/floor/plating/asteroid/airless,/area/ruin/space/has_grav)
"tY" = (/obj/item/stack/ore/silver{amount = 5; pixel_x = 7; pixel_y = -3},/turf/open/floor/plating/asteroid/airless,/area/ruin/space/has_grav)
"ue" = (/obj/item/stack/ore/iron{amount = 5; pixel_x = -10; pixel_y = 3},/turf/open/floor/plating/asteroid/airless,/area/ruin/space/has_grav)
"up" = (/obj/item/stack/ore/silver{amount = 5; pixel_x = 6; pixel_y = 5},/turf/open/floor/plating/asteroid/airless,/area/ruin/space/has_grav)
"uH" = (/obj/effect/decal/cleanable/dirt/dust,/obj/machinery/atmospherics/pipe/simple{dir = 10},/turf/open/floor/plating/airless,/area/ruin/space/has_grav/scav_mining/entrance)
"vn" = (/obj/machinery/power/port_gen/pacman,/obj/structure/cable{icon_state = "0-2"},/turf/open/floor/plating,/area/ruin/space/has_grav/scav_mining/core)
"vw" = (/obj/item/stack/ore/iron{amount = 15; pixel_x = 15; pixel_y = 5},/turf/open/floor/plating/asteroid/airless,/area/ruin/space/has_grav)
"wi" = (/obj/structure/cable{icon_state = "1-2"},/obj/machinery/atmospherics/pipe/simple{dir = 10},/turf/open/floor/plating,/area/ruin/space/has_grav/scav_mining/core)
"xv" = (/obj/machinery/door/airlock/hatch,/obj/structure/barricade/wooden,/obj/structure/cable{icon_state = "4-8"},/obj/machinery/atmospherics/pipe/simple{dir = 6},/turf/open/floor/plating/airless,/area/ruin/space/has_grav/scav_mining/core)
"xC" = (/obj/item/radio/off,/obj/effect/decal/cleanable/dirt/dust,/obj/structure/cable{icon_state = "1-2"},/obj/machinery/atmospherics/pipe/manifold/general{dir = 4},/turf/open/floor/plating,/area/ruin/space/has_grav/scav_mining/core)
"zo" = (/obj/machinery/atmospherics/pipe/simple{dir = 9},/turf/open/floor/plating/airless,/area/ruin/space/has_grav/scav_mining/entrance)
"zA" = (/obj/item/tank/internals/oxygen,/obj/item/tank/internals/oxygen,/obj/item/tank/jetpack/improvised,/turf/open/floor/plating,/area/ruin/space/has_grav/scav_mining/core)
"zH" = (/obj/machinery/door/airlock/hatch,/obj/structure/cable{icon_state = "1-2"},/obj/machinery/atmospherics/pipe/simple,/turf/open/floor/plating/airless,/area/ruin/space/has_grav/scav_mining/core)
"zO" = (/obj/effect/decal/cleanable/dirt/dust,/obj/structure/cable{icon_state = "4-8"},/turf/open/floor/plating,/area/ruin/space/has_grav/scav_mining/core)
"Ao" = (/obj/machinery/portable_atmospherics/canister/air,/turf/open/floor/plating/airless,/area/ruin/space/has_grav/scav_mining/entrance)
"Ax" = (/mob/living/simple_animal/hostile/asteroid/basilisk,/turf/open/floor/plating/asteroid/airless,/area/ruin/space/has_grav)
"Cs" = (/obj/machinery/light/small/broken{dir = 4},/turf/open/floor/plating/asteroid/airless,/area/ruin/space/has_grav)
"CG" = (/obj/structure/closet/crate,/obj/machinery/atmospherics/pipe/simple,/turf/open/floor/plating/airless,/area/ruin/space/has_grav/scav_mining/entrance)
"Dy" = (/obj/effect/decal/cleanable/dirt/dust,/obj/machinery/atmospherics/pipe/simple{dir = 4},/turf/open/floor/plating/airless,/area/ruin/space/has_grav/scav_mining/entrance)
"Dz" = (/turf/open/floor/plating/airless,/area/ruin/space/has_grav/scav_mining/entrance)
"Et" = (/obj/effect/decal/cleanable/dirt/dust,/obj/item/stack/sheet/metal,/turf/open/floor/plating/asteroid/airless,/area/ruin/space/has_grav)
"EB" = (/obj/item/stack/ore/titanium{amount = 10; pixel_x = 5; pixel_y = -2},/obj/effect/decal/cleanable/dirt/dust,/turf/open/floor/plating/asteroid/airless,/area/ruin/space/has_grav)
"Fn" = (/turf/closed/mineral/random/labormineral,/area/ruin/space/has_grav)
"Fp" = (/obj/item/stack/sheet/mineral/wood,/turf/open/floor/plating/airless,/area/ruin/space/has_grav/scav_mining/entrance)
"FV" = (/obj/effect/decal/remains/human,/obj/item/pickaxe/drill,/obj/item/mining_scanner,/obj/item/clothing/suit/space/hardsuit/mining,/turf/open/floor/plating/asteroid/airless,/area/ruin/space/has_grav)
"Gx" = (/obj/structure/cable{icon_state = "1-2"},/turf/open/floor/plating,/area/ruin/space/has_grav/scav_mining/dorm)
"Hr" = (/obj/structure/cable{icon_state = "1-2"},/obj/machinery/atmospherics/pipe/simple{dir = 5},/obj/item/stack/sheet/metal,/obj/item/stack/sheet/mineral/wood,/turf/open/floor/plating/airless,/area/ruin/space/has_grav/scav_mining/entrance)
"Hw" = (/obj/item/stack/ore/gold{amount = 2; pixel_x = 13; pixel_y = 10},/obj/effect/decal/cleanable/dirt/dust,/turf/open/floor/plating/asteroid/airless,/area/ruin/space/has_grav)
"HQ" = (/obj/structure/girder/displaced,/turf/open/floor/plating,/area/ruin/space/has_grav/scav_mining/dorm)
"Ia" = (/obj/effect/decal/cleanable/oil,/obj/machinery/door/airlock/hatch,/obj/machinery/atmospherics/pipe/simple{dir = 8},/turf/open/floor/plating/airless,/area/ruin/space/has_grav/scav_mining/core)
"Ii" = (/obj/machinery/atmospherics/pipe/simple{dir = 4},/turf/open/floor/plating,/area/ruin/space/has_grav/scav_mining/core)
"Iu" = (/obj/item/stack/medical/bruise_pack,/obj/machinery/atmospherics/pipe/manifold/general{dir = 1},/turf/open/floor/plating/airless,/area/ruin/space/has_grav/scav_mining/entrance)
"Ix" = (/obj/machinery/atmospherics/pipe/simple{dir = 6},/turf/open/floor/plating,/area/ruin/space/has_grav/scav_mining/core)
"IA" = (/turf/closed/mineral/random/high_chance,/area/ruin/space/has_grav)
"IG" = (/obj/machinery/portable_atmospherics/canister/oxygen,/turf/open/floor/plating,/area/ruin/space/has_grav/scav_mining/core)
"JB" = (/obj/machinery/airalarm/directional/south{pixel_y = -24},/turf/open/floor/plating/airless,/area/ruin/space/has_grav/scav_mining/entrance)
"JK" = (/turf/closed/wall/rust,/area/ruin/space/has_grav/scav_mining/core)
"Kp" = (/obj/structure/cable{icon_state = "1-4"},/obj/structure/cable{icon_state = "1-2"},/obj/structure/cable{icon_state = "1-8"},/obj/machinery/atmospherics/pipe/simple{dir = 5},/turf/open/floor/plating,/area/ruin/space/has_grav/scav_mining/core)
"KK" = (/obj/machinery/portable_atmospherics/scrubber,/turf/open/floor/plating,/area/ruin/space/has_grav/scav_mining/dorm)
"KU" = (/obj/machinery/portable_atmospherics/canister/nitrogen,/obj/machinery/atmospherics/components/unary/portables_connector{dir = 4},/turf/open/floor/plating,/area/ruin/space/has_grav/scav_mining/core)
"Le" = (/obj/structure/girder/displaced,/turf/open/floor/plating/asteroid/airless,/area/ruin/space/has_grav)
"Lm" = (/obj/item/stack/sheet/glass/fifty,/obj/machinery/atmospherics/components/unary/vent_pump,/turf/open/floor/plating,/area/ruin/space/has_grav/scav_mining/core)
"LT" = (/obj/effect/mob_spawn/human/miner/explorer,/obj/effect/decal/cleanable/blood,/turf/open/floor/plating,/area/ruin/space/has_grav/scav_mining/dorm)
"MZ" = (/obj/effect/decal/cleanable/blood,/obj/effect/mob_spawn/human/miner/explorer,/turf/open/floor/plating/asteroid/airless,/area/ruin/space/has_grav)
"No" = (/obj/machinery/atmospherics/pipe/simple,/turf/open/floor/plating/airless,/area/ruin/space/has_grav/scav_mining/entrance)
"ND" = (/obj/structure/barricade/sandbags,/turf/open/floor/plating/asteroid/airless,/area/ruin/space/has_grav)
"NE" = (/obj/structure/bed,/turf/open/floor/plating,/area/ruin/space/has_grav/scav_mining/dorm)
"Oz" = (/obj/effect/decal/cleanable/dirt/dust,/obj/structure/cable{icon_state = "1-4"},/turf/open/floor/plating/airless,/area/ruin/space/has_grav/scav_mining/entrance)
"OD" = (/obj/effect/decal/cleanable/dirt/dust,/obj/item/pipe{dir = 8},/obj/effect/decal/cleanable/ash,/turf/open/floor/plating/asteroid/airless,/area/ruin/space/has_grav)
"OI" = (/obj/structure/closet/crate,/obj/machinery/light/small/broken,/turf/open/floor/plating/airless,/area/ruin/space/has_grav/scav_mining/entrance)
"Pj" = (/obj/item/stack/ore/iron{amount = 15; pixel_x = -10; pixel_y = -4},/turf/open/floor/plating/asteroid/airless,/area/ruin/space/has_grav)
"PO" = (/obj/item/trash/pistachios,/turf/open/floor/plating,/area/ruin/space/has_grav/scav_mining/dorm)
"PT" = (/obj/structure/closet/crate,/turf/open/floor/plating/airless,/area/ruin/space/has_grav/scav_mining/entrance)
"Rp" = (/mob/living/simple_animal/hostile/asteroid/goliath/beast/ancient,/turf/open/floor/plating/asteroid/airless,/area/ruin/space/has_grav)
"RD" = (/turf/closed/wall/rust,/area/ruin/space/has_grav/scav_mining/entrance)
"Sd" = (/obj/machinery/power/apc/auto_name/east{pixel_x = 24},/obj/structure/cable,/turf/open/floor/plating,/area/ruin/space/has_grav/scav_mining/core)
"Sq" = (/obj/effect/decal/cleanable/dirt/dust,/obj/structure/cable{icon_state = "2-4"},/obj/machinery/atmospherics/pipe/simple{dir = 1},/turf/open/floor/plating,/area/ruin/space/has_grav/scav_mining/core)
"Su" = (/obj/machinery/atmospherics/pipe/simple{dir = 4},/turf/open/floor/plating/airless,/area/ruin/space/has_grav/scav_mining/entrance)
"Ti" = (/obj/machinery/power/apc/auto_name/east{pixel_x = 24},/obj/structure/cable{icon_state = "0-8"},/obj/item/stack/sheet/metal,/turf/open/floor/plating/airless,/area/ruin/space/has_grav/scav_mining/entrance)
"Tw" = (/obj/structure/closet/crate,/turf/open/floor/plating,/area/ruin/space/has_grav/scav_mining/dorm)
"TJ" = (/obj/machinery/atmospherics/pipe/simple{dir = 8},/turf/open/floor/plating/asteroid/airless,/area/ruin/space/has_grav)
"TT" = (/obj/machinery/suit_storage_unit/open,/turf/open/floor/plating,/area/ruin/space/has_grav/scav_mining/core)
"Uk" = (/obj/machinery/light/small/broken{dir = 8},/turf/open/floor/plating,/area/ruin/space/has_grav/scav_mining/dorm)
"Uz" = (/obj/effect/decal/cleanable/dirt/dust,/turf/open/floor/plating/asteroid/airless,/area/ruin/space/has_grav)
"UR" = (/obj/structure/flora/ash/space/voidmelon,/turf/open/floor/plating/asteroid/airless,/area/ruin/space/has_grav)
"Ve" = (/obj/item/stack/ore/bluespace_crystal{pixel_x = -5; pixel_y = 10},/turf/open/floor/plating/asteroid/airless,/area/ruin/space/has_grav)
"Vw" = (/obj/item/trash/can/food/beans,/obj/machinery/atmospherics/pipe/simple{dir = 4},/turf/open/floor/plating,/area/ruin/space/has_grav/scav_mining/dorm)
"Wk" = (/turf/closed/wall,/area/ruin/space/has_grav/scav_mining/core)
"WC" = (/obj/item/stack/sheet/metal,/turf/open/floor/plating/asteroid/airless,/area/ruin/space/has_grav)
"Xg" = (/obj/machinery/airalarm/directional/north{pixel_y = 24},/turf/open/floor/plating,/area/ruin/space/has_grav/scav_mining/core)
"Xn" = (/obj/structure/barricade/wooden,/obj/structure/cable{icon_state = "1-8"},/obj/machinery/atmospherics/pipe/simple{dir = 4},/turf/open/floor/plating,/area/ruin/space/has_grav/scav_mining/dorm)
"XD" = (/obj/machinery/atmospherics/components/trinary/mixer{dir = 4},/turf/open/floor/plating,/area/ruin/space/has_grav/scav_mining/core)
"YE" = (/obj/machinery/portable_atmospherics/canister/air,/turf/open/floor/plating,/area/ruin/space/has_grav/scav_mining/dorm)
"YF" = (/obj/structure/table,/obj/machinery/power/apc/auto_name/west{pixel_x = -24},/obj/structure/cable{icon_state = "0-2"},/turf/open/floor/plating,/area/ruin/space/has_grav/scav_mining/dorm)
"Zb" = (/obj/machinery/portable_atmospherics/canister/oxygen,/obj/machinery/atmospherics/components/unary/portables_connector{dir = 4},/obj/machinery/light/small/broken{dir = 8},/turf/open/floor/plating,/area/ruin/space/has_grav/scav_mining/core)
"Zi" = (/obj/item/trash/can/food/beans,/turf/open/floor/plating,/area/ruin/space/has_grav/scav_mining/dorm)
"ZC" = (/obj/machinery/atmospherics/pipe/simple{dir = 4},/obj/machinery/advanced_airlock_controller{pixel_y = 24},/obj/machinery/light/small/broken,/turf/open/floor/plating/airless,/area/ruin/space/has_grav/scav_mining/entrance)
"ZH" = (/turf/open/floor/plating,/area/ruin/space/has_grav/scav_mining/dorm)

(1,1,1) = {"
aaaaaaaaaaaaaaaaaaaaaaaaaaaaaaaaaaaaaaaaaaaaaaaaaaaaaaaaaaaaaaaaaaaaaaaaaaaaaaaaaaaaaaaaaaaaaapnaaaaaaaaaaaaaaaaaaaaaaaa
aaaaaaaaaaaaaaaaaaaaaaaaaaaaaaaaaaaaaaaaaaaaaaaaaaaaaaaaaaaaaaaaaaaaaaaaaaaaaaaaaaaaaaaaaaaaaaaaaaaaaaaaaaaaaaaaaaaaaaaa
aaaaaaaaaaaaaaaaaaaaaaaaaaaaaaaaaaaaaapnaaaaaaaaaaaaaaaaaaaaaaaaaaaaaaaaaaaaaaaaaaaaaaaaaaaaaaaaaaaaaaaaaaaaaaaaaaaaaaaa
aaaaaaaaaaaaaaaaaaaaaaaaaaaaaaaaaaaaaaaaaaaaaaaaaaaaaaaaaaaaaaaaaaaaaaaaaaaaaaaaaaaaaaaaaaaaaaaaaaaaaaaaaaaaaaaaaaaaaaaa
aaaaaaaaaaaaaaaaaaaaaaaaaaaaaaaaaaaaaaaaaaaaaaFnFnaaaaFnFnFnaQaaaapnaaFnFnFnFnaQaaaQaaaaaaaaaaaaaaaaaaaaaaaaaaaaaaaaaaaa
aaaaaaaaaaaaaaaaaaaaaaaaaaaaaaaaaaaaaaaaaaFnFnFnFnFnFnFnFnaQaQaaaaaaaQFnFnFnFnaQaQaQaQaaaaaaaaaaaaaaaaaaaaaaaaaaaaaaaaaa
aaaaaaaaaaaaaaaaaaaaaaaaaaaaaaaaFnFnFnFnFnFnFnFnFnFnFnaQaQFnauURUzFnFnFnFnFnFnFnFnFnFnaaaaaaaaaaaaaaaaaaaaaaaaaaaaaaaaaa
aaaaaaaaaaaaaaaaaaaaaaaaaaaaFnFnFnFnFnFnaQFnFnaQaQFnFnFnaubuauUzauFnFnFnaQaQFnFnFnFnFnFnFnFnaaaaaaaaaaaaaaaaaaaaaaaaaaaa
aaaaaaaaaaaaaaaaaaaaaaaaFnFnFnFnFnFnFnFnFnFnFnFnFnFnAxauoBMZauNDNDFnFnFnFnaQaQaQFnFnFnFnFnFnaQaQaaaaaaaaaaaaaaaaaaaaaaaa
aaaaaaaaaaaaaaaaaaaaaaFnFnFnFnFnFnFnaQFnauauUzauauauauaQaQaQaQaQauauauFnFnFnFnFnFnFnaQFnFnFnFnFnaaaaaaaaaaaaaapnaaaaaaaa
aaaaaaaaaaaaaaaaaaFnFnFnFnFnFnFnFnFnFnFnauauUzUzaQaQaQaQaQaQaQaQaQaQauauauaQaQaQFnFnaQFnFnFnFnFnaaaaaaaaaaaaaaaaaaaaaaaa
aaaaaaaaaaaaaaaaaaFnFnFnaQaQaQauaQaQaQaQaQaQauauaQaQaQaQaQaQaQaQaQaQauUzauauaQaQaQaQFnFnFnFnaQaQaQFnaaaaaaaaaaaaaaaaaaaa
aaaaaaaaaaaaaaaaaaFnFnFnaQaQaQauaQaQauauauUzauauaQaQaQaQFnFnaQIAaQaQaQauauaeauaQaQaQFnFnFnFnFnFnaQFnFnaaaaaaaaaaaaaaaaaa
aaaaaaaaaaaaaaaaaaFnFnaQaQaQFnauauaQauauUzUzaQaQaQaQaQaQIAaQaQaQaQFnFnaQaQauauauauaQaQaQaQFnFnFnFnFnFnFnFnaaaaaaaaaaaaaa
aaaaaaaaaaaaaaaaaaFnFnaQaQaQFnaQauauaQaQUzauaQaQaQaQaQaQIAaQaQaQaQaQaQaQaQaQaQIAauauauFnFnFnFnaQaQaQFnFnFnaaaaaaaaaaaaaa
aaaaaaaaaaaaaaaaaaaaFnFnaQFnFnaQaQauUzaQauauaQaQaQaQaQaQIAaQaQIAIAaQaQaQaQaQaQaQauauauFnaQFnFnFnaQaQFnaQFnaaaaaaaaaaaaaa
aaaaaaaaaaaaaaaaaaaaFnFnFnFnFnaQFnaQauUzUzauaQaQaQaQaQaQaQaQaQaQaQaQIAaQaQaQauauauauFnFnaQFnFnFnFnFnFnFnFnaaaaaaaaaaaaaa
aaaaaaaaaaaaaaaaaaaaaaFnFnFnFnFnFnaQaQaQauauaQaQaQaQaQIAaQaQaQIAaQaQaQaQaQaQauauauauFnaQaQFnFnFnFnFnaQFnFnaaaaFnaaaaaaaa
aaaaaaaaaaaaaaaaaaaaFnFnaQFnFnaQaQaQaQaQauauaQaQaQaQaQaQIAaQaQIAIAaQaQaQaQaQaQauauFnFnaQaQaQFnaQFnFnaQFnaaaaaaFnaaaaaaaa
aaaaaaaaaaaaaaaaaaaaFnFnFnFnaQaQaQaQaQaQauauaQaQaQaQIAIAIAaQaQaQIAaQIAaQaQaQaQaQauFnFnFnFnaQaQFnFnFnaQaaaaaaaaFnaaaaaaaa
aaaaaaaaaaaaaaaaaaaaFnFnFnaQaQaQaQaQaQauauaQaQaQaQaQIAIAIAIAaQIAaQaQaQaQaQaQaQIAauauauauFnFnFnFnaQFnFnaaaaaaaaaaaaaaaaaa
aaaaaaaaaaaaaaaaaaFnFnFnaQaQFnaQauaQauauUzaQaQFnaQIAIAIAautYauauauaQFnaQaQaQaQaQauauaQaQaQFnFnFnFnFnaaaaaaaaaaaaaaaaaaaa
aaaaaaaaaaaaaaaaaaFnFnaQaQFnauauayauUzUzauaQaQaQaQaQIAauAxauauauaQaQaQaQaQaQaQaQaQauauaQaQaQFnaQFnFnaQaaaaaaaaaaaaaaaaaa
aaaaaaaaaaaaaaaaaaFnFnaQaQaQauUzauauauaeaQaQaQaQaQIAauueauauupauaQIAIAaQaQaQFnaQaQaQauaQaQaQFnaQFnaQFnaaaapnaaaaaaaaaaaa
aaaaaaaaaaaaaaaaaaaQFnFnFnaQauaQaQaQaQaQaQIAaQaQaQIAaWauEBauautronIAaQaQaQaQaQaQaQaQauauaQaQaQFnFnFnFnaaaaaaaaaaaaaaaaaa
aaaaaaaaaaaaaaaaaaFnFnFnaQaQauaQaQaQaQaQaQaQaQaQaQIAagauauauauauauIAIAIAaQaQaQaQaQaQaQauaQaQaQFnFnaaaaaaaaaaaaaaaaaaaaaa
aaaaaaaaaaaaaaaaaaFnFnFnaQaQauUzauaQaQaQaQaQaQIAIAaQaUauauVeauauauURauIAaQaQaQaQaQaQaQauIAFnaQaQFnFnaaaaaaaaaaaaaaaaaaaa
aaaaaaaaaaaaaaaaaaFnFnFnaQaQUzUzauaQaQAxaQaQFnaQIAauUzautwUzRpUzHwauonIAaQaQaQaQFnaQaQauaQaQaQaQFnFnaaaaaaaaaaaaaaaaaaaa
aaaaaaaaaaaaaaaaaaFnFnFnaQaQbuauaQaQaQaQaQaQaQIAIAtrUzUzauFVauauauIAIAIAaQaQaQaQaQaQaQauauaQaQFnFnFnaaaaaaaaaaaaaaaaaaaa
aaaaaaaaaaaaaaaaaaFnaQFnaQaQauaQaQaQaQaQaQaQIAaQIAaQauURUzalauPjvwIAIAaQaQaQaQaQaQaQaQaQauaQaQFnFnFnaaaaaaaaaaaaaaaaaaaa
aaaaaaaaaaaaaaaaaaFnFnFnaQaQauaQaQaQaQaQaQaQaQaQaQIAaeautwauUzauaQIAIAaQaQaeaQaQaQaQaQaQauaQaQaQFnFnFnFnaaaaaaaaaaaaaaaa
aaaaaaaaaapnaaaaaaFnFnFnaQaQauaQaQaQaQaQaQIAaQaQaQIAVeaQIAaQtYvwauaQaQIAaQaQaQaQaQFnaQaQauaQaQaQaQFnaaaaaaaaaaaaaaaaaaaa
aaaaaaaaaaaaaaaaaaFnFnFnaQaQauauaQaQaQaQaQaQaQaQaQaQauaQIAaQaQauaubuIAaQaQIAaQaQaQaQaQIAauaQaQaQaQaQaQaaaaaaaaaaaaaaaaaa
aaaaaaaaaaaaaaaaaaFnFnFnaQaQauaQaQaQaQaQaQaQaQaQaQaQaQaQaQaQaQaQmSUzUzauUzIAaQaQaQaQauauauaQaQFnFnaQaQaaaaaaaaaaaaaaaaaa
aaaaaaaaaaaaaaaaaaFnFnFnaQaQauauaQaQaQaQaQaQaQaQIAaQaQaQaQaQaQaQaQaQaQIAauauauauauauauauaQFnFnaQaQaQaQaaaaaaaaaaaaaaaaaa
aaaaaaaaaaaaaaaaaaFnFnFnaQaQauauaQaQaQaQaQaQaQaQaQaQaQaQFnFnFnFnFnaQaQaQaQaQaQaQauAxaQaQaQFnaQaQaaaQaQaaaaaaaaaaaaaaaaaa
aaaaaaaaaaaaaaaaaaaaaaabababauaeauupauaQaQaQaQaQFnFnFnFnNEZHZHFnFnFnaQaQaQIAaQaQaQaQaQaQaQaQFnFnaaaaaaaaaaaaaaaaaaaaaaaa
aaaaaaaaaaaaaaaaaaFnFnFnaQaQaQauauauauaQaQaQFnFnFnFnFnYEZHZHZHFnZHFnFnaQaQaQaQaQaQaQaQaQaQaQFnFnaaaaaaaaaaaaaaaaaaaaaaaa
aaaaaaaaaaaaaaaaaaFnFnFnFnaQaQbuauUzLeJKJKWkJKJKJKWknwNEZHLTdKZiZHFnFnaQaQaQaQaQaQaQaQaQaQaQFnFnaaaaaaaaaaaaaaaaaaaaaaaa
aaaaaaaaaaaaaaaaaaFnFnFnaQFnaQUzauUzauWkTTTTTTXgvnWkYFlrZHkWgRZHZHFnFnaQaQaQaQaQaQaQaQaQFnFnFnFnaaaaaaaaaaaaaaaaaaaaaaaa
aaaaaaaaaaaaaaaaaaFnFnFnaQaQaQNDNDNDCsJKLmIxaOIiwiJKGxZHgRacnAZHZHFnFnFnFnaQaQaQaQaQaQFnFnFnFnFnaaaaaaaaaaaaaaaaaaaaaaaa
aaaaaaaaaaaaaaaaaaFnFnFnaQFnaQafqXODTJIafBgiSqzOKpxvXnVwsrpAhUkWNEFnFnFnFnaQFnFnaQaQaQFnFnFnFnFnaapnaaaaaaaaaaaaaaaaaaaa
aaaaaaaaaaaaaaaaaaaaFnFnFnFnaQUzrlUzauJKZbXDxCqPSdJKezTwacnALTPOZHHQFnFnFnFnFnFnFnFnFnFnFnFnFnaaaaaaaaaaaaaaaaaaaaaaaaaa
aaaaaaaaaaaaaaaaaaaaFnFnaQaQaQauEtaeaQJKKUcqaSzAIGJKcsZHZHdKTwZHNEZHFnFnFnFnFnFnFnFnFnFnFnFnaaaaaaaaaaaaaaaaaaaaaaaaaaaa
aaaaaaaaaaaaaaaaaaaaaaFnFnFnaQLeaDauaQWkWkJKzHWkJKJKUkTwkWKKHQFnFnFnFnFnFnFnFnFnFnFnFnFnaaaaaaaaaaaaaaaaaaaaaaaaaaaaaaaa
aaaaaaaaaaaaaaaaaaaaFnFnFnFnFnauauWCFnFnpwDznEDzcpaQFnFnFnFnFnFnFnFnFnFnFnFnFnaaaaaaaaaaaaaaaaaaaaaaaaaaaaaaaaaaaaaaaaaa
aaaaaaaaaaaaaaaaaaaaaaFnFnFnFnFnFnauFnFnAorHHrDyuHgxFnFnFnFnFnaaaaaaaaFnFnFnFnaaaaaaaaaaaaaaaaaaaaaaaaaaaaaaaaaaaaaaaaaa
aaaaaaaaaaaaaaaaaaaaaaFnFnFnFnFnauauauaQDzrHbaDzNogxaaaaaaaaaaaaaaaaaaaaaaaaaaaaaaaaaaaaaaaaaaaaaaaaaaaaaaaaaaaaaaaaaaaa
aaaaaaaaaaaaaaaaaaaaaaaaaaFnFnFnLeWCauauFpaMhlIuzogxaaaaaaaaaaaaaaaaaaaaaaaaaaaaaaaaaaaaaapnaaaaaaaaaaaaaaaaaaaaaaaaaaaa
aaaaaaaaaaaaaaaaaaaaaaaaaaFnFnFnFnFnFnFnFnpEOzrMTiRDaaaaaaaaaaaaaaaaaaaaaaaaaaaaaaaaaaaaaaaaaaaaaaaaaaaaaaaaaaaaaaaaaaaa
aaaaaaaaaaaaaaaaaaaaaaaaaaaaaaaaaaaaFnFnFnDzPTNorHRDaaaaaaaapnaaaaaaaaaaaaaaaaaaaaaaaaaaaaaaaaaaaaaaaaaaaaaaaaaaaaaaaaaa
aaaaaaaaaaaaaaaaaaaaaaaaaaaaaaaaaaaaaaFnFnFnPTCGDzRDRDRDgxaaaaaaaaaaaaaaaaaaaaaaaaaaaaaaaaaaaaaaaaaaaaaaaaaaaaaaaaaaaaaa
aaaaaaaaaaaaaaaapnaaaaaaaaaaaaaaaaaaaaaaFnFnDzqbSuakZCgandaaaaaaaaaaaaaaaaaaaaaaaaaaaaaaaaaaaaaaaaaaaaaaaaaaaaaaaaaaaaaa
aaaaaaaaaaaaaaaaaaaaaaaaaaaaaaaaaaaaaaaaaaFnJBOIDzgxgxRDgxaaaaaaaaaaaaaaaaaaaaaaaaaaaaaaaaaaaaaaaaaaaaaaaaaaaaaaaaaaaaaa
aaaaaaaaaaaaaaaaaaaaaaaaaaaaaaaaaaaaaaaaaagxgxRDRDgxaaaaaaaaaaaaaaaaaaaaaaaaaaaaaaaaaaaaaaaaaaaaaaaaaaaaaaaaaaaaaaaaaaaa
aaaaaaaaaaaaaaaaaaaaaaaaaaaaaaaaaaaaaaaaaaaaaaaaaaaaaaaaaaaaaaaaaaaaaaaaaaaaaaaaaaaaaaaaaaaaaaaaaaaaaaaaaaaaaaaaaaaaaaaa
aaaaaaaaaaaaaaaaaaaaaaaaaaaaaaaaaaaaaaaaaaaaaaaaaaaaaapnaaaaaaaaaaaaaaaaaaaaaaaaaaaaaaaaaaaaaaaaaaaaaaaaaaaaaaaaaaaaaaaa
aaaaaaaaaaaaaaaaaaaaaaaaaaaaaaaaaaaaaaaaaaaaaaaaaaaaaaaaaaaaaaaaaaaaaaaaaaaaaaaaaaaaaaaaaaaapnaaaaaaaaaaaaaaaaaaaaaaaaaa
aaaaaaaaaaaaaaaaaaaaaaaaaaaaaaaaaaaaaaaaaaaaaaaaaaaaaaaaaaaaaaaaaaaaaaaaaaaaaaaaaaaaaaaaaaaaaaaaaaaaaaaaaaaaaaaaaaaaaaaa
aaaaaaaaaaaaaaaaaaaaaaaaaaaaaaaaaaaaaaaaaaaaaaaaaaaaaaaaaaaaaaaaaaaaaaaaaaaaaaaaaaaaaaaaaaaaaaaaaaaaaaaaaaaaaaaaaaaaaaaa
"}
