"a" = (/obj/structure/chair/stool,/turf/open/floor/iron/airless,/area/ruin/space/has_grav/spacegym)
"b" = (/obj/structure/chair/stool,/mob/living/simple_animal/hostile/zombie{desc = "Hey buddy, I think you got the wrong door. Leather club is two blocks down."; environment_smash = 0; health = 60; melee_damage_lower = 11; melee_damage_upper = 11; name = "Boss of this Gym"; zombiejob = null},/turf/open/floor/iron/airless,/area/ruin/space/has_grav/spacegym)
"c" = (/mob/living/simple_animal/hostile/zombie/leatherman{a_intent = "Leatherman"; environment_smash = 0; zombiejob = null},/turf/open/floor/iron/airless,/area/ruin/space/has_grav/spacegym)
"d" = (/obj/item/reagent_containers/glass/bucket,/turf/open/floor/iron/airless,/area/ruin/space/has_grav/spacegym)
"e" = (/obj/item/clothing/under/costume/jabroni,/turf/open/floor/iron/airless,/area/ruin/space/has_grav/spacegym)
"f" = (/obj/effect/decal/cleanable/oil,/turf/open/floor/iron/airless,/area/ruin/space/has_grav/spacegym)
"h" = (/obj/machinery/door/airlock,/turf/open/floor/iron/airless,/area/ruin/space/has_grav/spacegym)
"m" = (/obj/item/reagent_containers/food/snacks/meatball,/turf/open/floor/iron/airless,/area/ruin/space/has_grav/spacegym)
"n" = (/turf/open/floor/iron/airless,/area/ruin/space/has_grav/spacegym)
"o" = (/obj/effect/spawner/lootdrop/maintenance,/turf/open/floor/iron/airless,/area/ruin/space/has_grav/spacegym)
"s" = (/obj/machinery/shower,/obj/effect/decal/cleanable/cobweb/cobweb2,/obj/item/storage/pill_bottle/floorpill/full,/turf/open/floor/iron/airless,/area/ruin/space/has_grav/spacegym)
"u" = (/turf/open/space/basic,/area/space)
"v" = (/obj/item/reagent_containers/spray/cleaner,/turf/open/floor/iron/airless,/area/ruin/space/has_grav/spacegym)
"y" = (/obj/structure/closet/boxinggloves,/obj/effect/decal/cleanable/cobweb,/turf/open/floor/iron/airless,/area/ruin/space/has_grav/spacegym)
"z" = (/obj/structure/closet/boxinggloves,/obj/effect/decal/cleanable/cobweb/cobweb2,/turf/open/floor/iron/airless,/area/ruin/space/has_grav/spacegym)
"B" = (/obj/structure/weightmachine/stacklifter,/obj/effect/spawner/lootdrop/spacegym,/turf/open/floor/iron/airless,/area/ruin/space/has_grav/spacegym)
"E" = (/mob/living/simple_animal/hostile/zombie{desc = "He's the boy next door."; environment_smash = 0; health = 60; melee_damage_lower = 11; melee_damage_upper = 11; name = "Boy Next Door"; zombiejob = null},/turf/open/floor/iron/airless,/area/ruin/space/has_grav/spacegym)
"F" = (/obj/machinery/shower,/turf/open/floor/iron/airless,/area/ruin/space/has_grav/spacegym)
"G" = (/obj/effect/spawner/lootdrop/spacegym,/turf/open/floor/iron/airless,/area/ruin/space/has_grav/spacegym)
"I" = (/obj/structure/lattice,/turf/open/space/basic,/area/ruin/space/has_grav/spacegym)
"J" = (/obj/structure/weightmachine/weightlifter,/turf/open/floor/iron/airless,/area/ruin/space/has_grav/spacegym)
"L" = (/obj/structure/lattice,/obj/structure/grille,/turf/open/space/basic,/area/ruin/space/has_grav/spacegym)
"O" = (/turf/closed/wall,/area/ruin/space/has_grav/spacegym)
"Q" = (/obj/structure/closet,/turf/open/floor/iron/airless,/area/ruin/space/has_grav/spacegym)
"R" = (/obj/item/mop,/obj/structure/mopbucket,/turf/open/floor/iron/airless,/area/ruin/space/has_grav/spacegym)
"U" = (/obj/structure/grille,/turf/open/floor/iron/airless,/area/ruin/space/has_grav/spacegym)
"V" = (/obj/structure/chair/stool,/obj/item/reagent_containers/glass/rag,/turf/open/floor/iron/airless,/area/ruin/space/has_grav/spacegym)
"X" = (/obj/effect/decal/cleanable/vomit,/turf/open/floor/iron/airless,/area/ruin/space/has_grav/spacegym)

(1,1,1) = {"
uuuuuuuuuuuu
uuunUIfuuuuu
uIuuIIIUIIvu
IOOOOUOUOOUu
uOybnVzOFsOu
IOQaGaQOIEUI
GOQanaQOneIL
nOQanaQOGnOL
IOXocnUhdUUu
IOBmUnJOUROu
IUOOhOOOUIOu
uuUnuuuuuuuu
"}
