//MAP CONVERTED BY dmm2tgm.py THIS HEADER COMMENT PREVENTS RECONVERSION, DO NOT REMOVE
"az" = (
/obj/structure/window/reinforced/survival_pod,
/obj/structure/window/reinforced/survival_pod{
	dir = 4
	},
/turf/open/floor/mineral/plastitanium,
/area/ship/bridge)
"aA" = (
/obj/structure/frame/computer{
	anchored = 1
	},
/obj/effect/turf_decal/siding/thinplating/dark,
/turf/open/floor/iron/dark,
/area/ship/bridge)
"aJ" = (
/obj/structure/sink{
	dir = 1
	},
/obj/structure/mirror{
	pixel_y = -30
	},
/obj/machinery/light,
/turf/open/floor/iron/freezer,
/area/ship/bridge)
"aW" = (
/obj/machinery/computer/autopilot,
/obj/effect/turf_decal/siding/thinplating/dark,
/turf/open/floor/iron/dark,
/area/ship/bridge)
"bD" = (
/obj/structure/window/reinforced/survival_pod{
	dir = 8
	},
/obj/effect/turf_decal/syndicateemblem/bottom/left,
/turf/open/floor/mineral/plastitanium/red,
/area/ship/bridge)
"bF" = (
/obj/item/storage/firstaid/advanced,
/obj/machinery/light{
	dir = 1
	},
/obj/structure/table/reinforced/plastitaniumglass,
/obj/effect/turf_decal/siding/thinplating/dark{
	dir = 4
	},
/turf/open/floor/iron/dark,
/area/ship/bridge)
"cS" = (
/obj/structure/chair/comfy/shuttle{
	dir = 1
	},
/turf/open/floor/mineral/plastitanium,
/area/ship/bridge)
"de" = (
/turf/open/floor/iron/freezer,
/area/ship/bridge)
"eI" = (
/obj/structure/table/reinforced/plastitaniumglass,
/obj/effect/turf_decal/siding/thinplating/dark{
	dir = 4
	},
/turf/open/floor/iron/dark,
/area/ship/bridge)
"gb" = (
/obj/effect/turf_decal/syndicateemblem/top/middle,
/turf/open/floor/mineral/plastitanium/red,
/area/ship/bridge)
"gG" = (
/obj/machinery/light/floor,
/turf/open/floor/mineral/plastitanium,
/area/ship/bridge)
"io" = (
/obj/structure/chair/bronze,
/obj/machinery/door/window/survival_pod{
	dir = 1;
	name = "Front Desk"
	},
/turf/open/floor/mineral/plastitanium,
/area/ship/bridge)
"iX" = (
/obj/structure/window/reinforced/survival_pod{
	dir = 4
	},
/obj/structure/window/reinforced/survival_pod{
	dir = 1
	},
/turf/open/floor/mineral/plastitanium,
/area/ship/bridge)
"lm" = (
/obj/machinery/atmospherics/components/unary/tank/air,
/obj/structure/curtain/cloth/grey,
/turf/open/floor/iron/freezer,
/area/ship/bridge)
"oK" = (
/obj/machinery/power/shuttle/engine/void{
	dir = 1
	},
/turf/open/floor/plating,
/area/ship/bridge)
"pO" = (
/obj/structure/table/reinforced/plastitaniumglass,
/obj/effect/turf_decal/siding/thinplating/dark{
	dir = 8
	},
/obj/item/storage/belt/utility,
/obj/item/multitool,
/turf/open/floor/iron/dark,
/area/ship/bridge)
"pY" = (
/obj/structure/table/reinforced,
/turf/open/floor/carpet/red_gold,
/area/ship/bridge)
"rm" = (
/obj/structure/table/reinforced/plastitaniumglass,
/obj/effect/turf_decal/siding/thinplating/dark{
	dir = 4
	},
/obj/structure/window/reinforced/survival_pod,
/turf/open/floor/iron/dark,
/area/ship/bridge)
"sq" = (
/obj/machinery/door/airlock/external/glass,
/obj/structure/fans/tiny,
/obj/docking_port/mobile{
	can_move_docking_ports = 1;
	dwidth = 5;
	height = 13;
	launch_status = 0;
	port_direction = 2;
	width = 11
	},
/turf/open/floor/plating,
/area/ship/bridge)
"th" = (
/obj/machinery/light/floor,
/obj/effect/turf_decal/syndicateemblem/middle/middle,
/turf/open/floor/mineral/plastitanium/red,
/area/ship/bridge)
"tv" = (
/obj/structure/shuttle/engine/heater,
/obj/structure/window/reinforced/spawner,
/obj/effect/turf_decal/industrial/warning/dust{
	dir = 1
	},
/turf/open/floor/plating,
/area/ship/bridge)
"up" = (
/obj/structure/window/reinforced/survival_pod,
/turf/open/floor/mineral/plastitanium,
/area/ship/bridge)
"uS" = (
/obj/structure/window/reinforced/survival_pod{
	dir = 4
	},
/obj/effect/turf_decal/syndicateemblem/top/right,
/turf/open/floor/mineral/plastitanium/red,
/area/ship/bridge)
"vt" = (
/obj/structure/window/reinforced/survival_pod{
	dir = 4
	},
/obj/structure/table/reinforced/plastitaniumglass,
/obj/item/encryptionkey/wideband{
	pixel_y = 5
	},
/turf/open/floor/mineral/plastitanium,
/area/ship/bridge)
"wJ" = (
/obj/structure/tank_dispenser/oxygen,
/obj/machinery/light,
/obj/structure/window/reinforced/survival_pod{
	dir = 8
	},
/turf/open/floor/mineral/plastitanium,
/area/ship/bridge)
"wV" = (
/obj/item/radio/intercom/wideband{
	pixel_y = -32
	},
/obj/structure/window/reinforced/survival_pod{
	dir = 8
	},
/obj/structure/window/reinforced/survival_pod{
	dir = 1
	},
/turf/open/floor/mineral/plastitanium,
/area/ship/bridge)
"xx" = (
/obj/machinery/light{
	dir = 1
	},
/obj/structure/table/reinforced,
/obj/structure/curtain/cloth/grey{
	pixel_x = -32
	},
/turf/open/floor/carpet/red_gold,
/area/ship/bridge)
"yX" = (
/obj/machinery/shower{
	dir = 1
	},
/obj/structure/curtain,
/obj/machinery/light{
	dir = 8
	},
/turf/open/floor/iron/freezer,
/area/ship/bridge)
"Au" = (
/obj/structure/bed,
/obj/item/bedsheet/syndie,
/obj/structure/curtain/cloth/grey,
/turf/open/floor/carpet/red_gold,
/area/ship/bridge)
"Ba" = (
/obj/structure/window/reinforced/survival_pod{
	dir = 8
	},
/obj/effect/turf_decal/syndicateemblem/top/left,
/turf/open/floor/mineral/plastitanium/red,
/area/ship/bridge)
"BI" = (
/obj/item/trash/plate,
/obj/structure/table/reinforced/rglass,
/obj/structure/curtain/cloth/grey{
	pixel_x = 32
	},
/turf/open/floor/carpet/red_gold,
/area/ship/bridge)
"EK" = (
/obj/structure/window/reinforced/survival_pod{
	dir = 4
	},
/obj/effect/turf_decal/syndicateemblem/bottom/right,
/turf/open/floor/mineral/plastitanium/red,
/area/ship/bridge)
"EY" = (
/obj/machinery/light{
	dir = 1
	},
/obj/structure/table/reinforced/plastitaniumglass,
/obj/effect/turf_decal/siding/thinplating/dark{
	dir = 8
	},
/obj/item/storage/toolbox/mechanical/old/clean,
/turf/open/floor/iron/dark,
/area/ship/bridge)
"GQ" = (
/obj/machinery/door/window/westright{
	dir = 2
	},
/turf/open/floor/mineral/plastitanium,
/area/ship/bridge)
"Hu" = (
/obj/machinery/door/window/westright,
/obj/effect/turf_decal/syndicateemblem/middle/left,
/turf/open/floor/mineral/plastitanium/red,
/area/ship/bridge)
"HJ" = (
/obj/structure/window/reinforced/survival_pod,
/obj/structure/window/reinforced/survival_pod{
	dir = 8
	},
/turf/open/floor/mineral/plastitanium,
/area/ship/bridge)
"HZ" = (
/obj/effect/mob_spawn/human/lavaland_syndicate/comms{
	dir = 4
	},
/obj/structure/curtain/cloth/grey{
	pixel_x = -32
	},
/turf/open/floor/carpet/red_gold,
/area/ship/bridge)
"Jz" = (
/obj/machinery/vending/autodrobe/all_access{
	default_price = 0;
	extra_price = 0
	},
/turf/open/floor/carpet/red_gold,
/area/ship/bridge)
"Kn" = (
/obj/machinery/computer/helm,
/obj/effect/turf_decal/siding/thinplating/dark,
/turf/open/floor/iron/dark,
/area/ship/bridge)
"Kr" = (
/turf/open/floor/mineral/plastitanium,
/area/ship/bridge)
"Ky" = (
/turf/open/space/basic,
/area/space)
"KK" = (
/obj/effect/turf_decal/syndicateemblem/bottom/middle,
/turf/open/floor/mineral/plastitanium/red,
/area/ship/bridge)
"Lu" = (
/obj/item/kitchen/knife,
/obj/structure/table/reinforced/rglass,
/obj/structure/curtain/cloth/grey{
	pixel_x = 32
	},
/turf/open/floor/carpet/red_gold,
/area/ship/bridge)
"Mj" = (
/obj/machinery/suit_storage_unit/standard_unit,
/obj/machinery/light,
/obj/structure/window/reinforced/survival_pod{
	dir = 4
	},
/turf/open/floor/mineral/plastitanium,
/area/ship/bridge)
"Mo" = (
/obj/machinery/microwave{
	pixel_y = 6
	},
/obj/machinery/light{
	dir = 4
	},
/obj/structure/table/reinforced,
/turf/open/floor/carpet/red_gold,
/area/ship/bridge)
"MW" = (
/obj/structure/curtain/cloth/grey,
/obj/structure/table,
/turf/open/floor/iron/freezer,
/area/ship/bridge)
"Nh" = (
/obj/machinery/door/window{
	dir = 4
	},
/obj/effect/turf_decal/syndicateemblem/middle/right,
/turf/open/floor/mineral/plastitanium/red,
/area/ship/bridge)
"Ob" = (
/obj/structure/chair/plastic{
	dir = 4
	},
/turf/open/floor/carpet/red_gold,
/area/ship/bridge)
"Ph" = (
/obj/machinery/light/floor,
/obj/item/radio/intercom,
/obj/structure/table/reinforced/plastitaniumglass,
/turf/open/floor/mineral/plastitanium,
/area/ship/bridge)
"Qw" = (
/obj/structure/toilet{
	dir = 4
	},
/obj/structure/window/reinforced/survival_pod{
	dir = 1
	},
/turf/open/floor/iron/freezer,
/area/ship/bridge)
"QG" = (
/obj/structure/window/reinforced/survival_pod{
	dir = 8
	},
/obj/structure/table/reinforced/plastitaniumglass,
/turf/open/floor/mineral/plastitanium,
/area/ship/bridge)
"Rj" = (
/obj/machinery/door/window{
	dir = 1
	},
/turf/open/floor/iron/freezer,
/area/ship/bridge)
"Tq" = (
/turf/open/floor/carpet/red_gold,
/area/ship/bridge)
"Ve" = (
/obj/effect/spawner/structure/window/shuttle,
/turf/open/floor/plating,
/area/ship/bridge)
"Vx" = (
/obj/machinery/light{
	dir = 1
	},
/obj/structure/table/reinforced,
/obj/structure/curtain/cloth/grey{
	pixel_x = 32
	},
/turf/open/floor/carpet/red_gold,
/area/ship/bridge)
"VS" = (
/obj/machinery/telecomms/allinone,
/obj/effect/turf_decal/siding/thinplating/dark{
	dir = 8
	},
/obj/structure/window/reinforced/survival_pod,
/turf/open/floor/iron/dark,
/area/ship/bridge)
"Xu" = (
/obj/effect/spawner/lootdrop/donkpockets,
/obj/effect/spawner/lootdrop/donkpockets,
/obj/structure/closet/secure_closet/freezer,
/obj/effect/spawner/lootdrop/donkpockets,
/obj/effect/spawner/lootdrop/donkpockets,
/turf/open/floor/carpet/red_gold,
/area/ship/bridge)
"Ya" = (
/obj/machinery/holopad,
/obj/structure/chair/comfy/teal{
	dir = 1
	},
/obj/machinery/door/window/survival_pod{
	name = "Front Desk"
	},
/turf/open/floor/mineral/plastitanium,
/area/ship/bridge)
"Yx" = (
/turf/closed/wall/mineral/titanium/nodiagonal,
/area/ship/bridge)
"Zp" = (
/obj/structure/curtain/cloth/grey,
/obj/structure/table,
/obj/structure/window/reinforced/survival_pod{
	dir = 1
	},
/turf/open/floor/iron/freezer,
/area/ship/bridge)

(1,1,1) = {"
Ky
Ky
Ky
Ky
Ky
Ky
Yx
Ve
Yx
Yx
Yx
Ky
Ky
"}
(2,1,1) = {"
Ky
Ky
Ky
Ky
Yx
Ve
Yx
HZ
Qw
aJ
Yx
Yx
Ky
"}
(3,1,1) = {"
Ky
Yx
Ve
Ve
Yx
xx
Tq
Tq
Rj
de
yX
Yx
Yx
"}
(4,1,1) = {"
Yx
Yx
bF
eI
rm
Au
Tq
Jz
Zp
MW
lm
tv
oK
"}
(5,1,1) = {"
Ve
aA
Kr
Kr
up
Ba
Hu
bD
wV
QG
HJ
wJ
Yx
"}
(6,1,1) = {"
Ve
Kn
cS
gG
GQ
gb
th
KK
io
Ph
Ya
Kr
sq
"}
(7,1,1) = {"
Ve
aW
Kr
Kr
up
uS
Nh
EK
iX
vt
az
Mj
Yx
"}
(8,1,1) = {"
Yx
Yx
EY
pO
VS
pY
Tq
Tq
Tq
Tq
Xu
tv
oK
"}
(9,1,1) = {"
Ky
Yx
Ve
Ve
Yx
Vx
Tq
Ob
Ob
Ob
Mo
Yx
Yx
"}
(10,1,1) = {"
Ky
Ky
Ky
Ky
Yx
Ve
Yx
BI
BI
Lu
Yx
Yx
Ky
"}
(11,1,1) = {"
Ky
Ky
Ky
Ky
Ky
Ky
Yx
Ve
Ve
Ve
Yx
Ky
Ky
"}
