"a" = (/turf/template_noop,/area/template_noop)
"b" = (/turf/closed/wall/mineral/plastitanium/nodiagonal,/area/ruin/powered)
"c" = (/obj/effect/decal/cleanable/cobweb,/turf/closed/wall/mineral/plastitanium/nodiagonal,/area/ruin/powered)
"e" = (/obj/item/gun/ballistic/automatic/pistol,/obj/structure/table,/obj/effect/decal/cleanable/dirt/dust,/turf/open/floor/mineral/plastitanium,/area/ruin/powered)
"g" = (/obj/structure/punji_sticks,/obj/structure/flora/grass/jungle,/obj/effect/decal/cleanable/blood/gibs/down,/turf/open/floor/plating/dirt,/area/ruin/unpowered)
"h" = (/obj/structure/punji_sticks,/obj/structure/flora/ausbushes/sparsegrass,/obj/effect/decal/remains/human,/turf/open/floor/plating/dirt,/area/ruin/unpowered)
"i" = (/obj/structure/table,/obj/item/storage/toolbox/syndicate,/turf/open/floor/mineral/plastitanium,/area/ruin/powered)
"j" = (/obj/machinery/ntnet_relay,/turf/open/floor/mineral/plastitanium,/area/ruin/powered)
"k" = (/obj/machinery/power/port_gen/pacman,/obj/effect/decal/cleanable/dirt/dust,/turf/open/floor/mineral/plastitanium,/area/ruin/powered)
"l" = (/obj/machinery/computer{dir = 8},/obj/effect/decal/cleanable/dirt/dust,/turf/open/floor/mineral/plastitanium,/area/ruin/powered)
"m" = (/obj/structure/punji_sticks,/obj/structure/flora/junglebush,/obj/effect/decal/remains/human,/turf/open/floor/plating/dirt,/area/ruin/unpowered)
"n" = (/obj/structure/flora/junglebush/c,/turf/open/floor/plating/dirt,/area/ruin/unpowered)
"p" = (/obj/machinery/porta_turret/syndicate/pod{dir = 10},/turf/closed/wall/mineral/plastitanium/nodiagonal,/area/ruin/powered)
"q" = (/obj/structure/punji_sticks,/obj/structure/flora/rock/jungle,/obj/effect/decal/remains/human,/turf/open/floor/plating/dirt,/area/ruin/unpowered)
"r" = (/obj/structure/table,/obj/item/grenade/frag,/obj/item/grenade/frag,/obj/item/grenade/frag,/turf/open/floor/mineral/plastitanium,/area/ruin/powered)
"t" = (/obj/structure/window/plasma/reinforced/plastitanium,/obj/structure/grille,/turf/open/floor/plating,/area/ruin/powered)
"u" = (/obj/machinery/porta_turret/syndicate/pod{dir = 6},/turf/closed/wall/mineral/plastitanium/nodiagonal,/area/template_noop)
"v" = (/obj/structure/flora/junglebush/large,/turf/open/floor/plating/dirt,/area/ruin/unpowered)
"x" = (/obj/effect/decal/cleanable/dirt/dust,/obj/structure/sign/poster/contraband/revolver,/turf/closed/wall/mineral/plastitanium/nodiagonal,/area/ruin/powered)
"y" = (/obj/structure/chair/plastic{dir = 4},/turf/open/floor/mineral/plastitanium,/area/ruin/powered)
"A" = (/obj/effect/decal/cleanable/dirt/dust,/obj/structure/table,/obj/item/kitchen/knife/combat,/obj/effect/decal/cleanable/dirt/dust,/turf/open/floor/mineral/plastitanium,/area/ruin/powered)
"C" = (/obj/structure/table,/obj/item/clothing/gloves/combat,/obj/item/clothing/shoes/combat,/obj/item/clothing/mask/gas/syndicate,/turf/open/floor/mineral/plastitanium,/area/ruin/powered)
"E" = (/obj/structure/punji_sticks,/obj/structure/flora/ausbushes/fernybush,/obj/effect/decal/cleanable/blood/gibs/limb,/turf/open/floor/plating/dirt,/area/ruin/unpowered)
"F" = (/obj/structure/rack,/obj/item/stack/sheet/mineral/plasma,/obj/effect/decal/cleanable/dirt/dust,/turf/open/floor/mineral/plastitanium,/area/ruin/powered)
"G" = (/mob/living/simple_animal/hostile/syndicate/ranged/smg/pilot,/turf/open/floor/mineral/plastitanium,/area/ruin/powered)
"H" = (/obj/structure/punji_sticks,/obj/structure/flora/ausbushes/fullgrass,/turf/open/floor/plating/dirt,/area/ruin/unpowered)
"J" = (/obj/structure/punji_sticks,/obj/structure/flora/ausbushes/fullgrass,/obj/effect/decal/remains/human,/turf/open/floor/plating/dirt,/area/ruin/unpowered)
"K" = (/obj/machinery/computer{dir = 1},/turf/open/floor/mineral/plastitanium,/area/ruin/powered)
"M" = (/obj/structure/sign/poster/contraband/free_key,/turf/closed/wall/mineral/plastitanium/nodiagonal,/area/ruin/powered)
"N" = (/obj/structure/punji_sticks,/obj/structure/flora/ausbushes/lavendergrass,/obj/effect/decal/cleanable/blood/gibs/up,/turf/open/floor/plating/dirt,/area/ruin/unpowered)
"S" = (/obj/effect/decal/cleanable/dirt/dust,/turf/open/floor/mineral/plastitanium,/area/ruin/powered)
"T" = (/obj/structure/punji_sticks,/obj/structure/flora/ausbushes/lavendergrass,/obj/effect/decal/cleanable/blood/gibs/torso,/turf/open/floor/plating/dirt,/area/ruin/unpowered)
"U" = (/obj/machinery/door/airlock/hatch,/obj/effect/decal/cleanable/dirt/dust,/turf/open/floor/plating,/area/ruin/powered)
"V" = (/turf/open/floor/mineral/plastitanium,/area/ruin/powered)
"W" = (/obj/structure/flora/tree/jungle,/turf/open/floor/plating/dirt,/area/ruin/unpowered)
"X" = (/obj/machinery/light/broken{dir = 1},/obj/structure/chair/plastic,/mob/living/simple_animal/hostile/syndicate/ranged,/turf/open/floor/mineral/plastitanium,/area/ruin/powered)
"Z" = (/obj/machinery/light,/turf/open/floor/mineral/plastitanium,/area/ruin/powered)

(1,1,1) = {"
aaaWvnaaa
aabbUbbaa
JbcjSGxbN
gtkSZVrtE
HtFSbylth
mtiSXSeta
apMCKAbua
aabtttbaa
aaaTqaaaa
"}
