//MAP CONVERTED BY dmm2tgm.py THIS HEADER COMMENT PREVENTS RECONVERSION, DO NOT REMOVE
"a" = (
/turf/template_noop,
/area/template_noop)
"b" = (
/turf/closed/wall/mineral/plastitanium/nodiagonal,
/area/ruin/powered)
"c" = (
/obj/effect/decal/cleanable/cobweb,
/turf/closed/wall/mineral/plastitanium/nodiagonal,
/area/ruin/powered)
"e" = (
/obj/item/gun/ballistic/automatic/pistol,
/obj/structure/table,
/obj/effect/decal/cleanable/dirt/dust,
/turf/open/floor/mineral/plastitanium,
/area/ruin/powered)
"g" = (
/obj/structure/punji_sticks,
/obj/structure/flora/grass/jungle,
/obj/effect/decal/cleanable/blood/gibs/down,
/turf/open/floor/plating/dirt,
/area/ruin/unpowered)
"h" = (
/obj/structure/punji_sticks,
/obj/structure/flora/ausbushes/sparsegrass,
/obj/effect/decal/remains/human,
/turf/open/floor/plating/dirt,
/area/ruin/unpowered)
"i" = (
/obj/structure/table,
/obj/item/storage/toolbox/syndicate,
/turf/open/floor/mineral/plastitanium,
/area/ruin/powered)
"j" = (
/obj/machinery/ntnet_relay,
/obj/structure/sign/poster/contraband/m90{
	pixel_x = -32
	},
/turf/open/floor/mineral/plastitanium,
/area/ruin/powered)
"k" = (
/obj/machinery/power/port_gen/pacman,
/obj/effect/decal/cleanable/dirt/dust,
/turf/open/floor/mineral/plastitanium,
/area/ruin/powered)
"l" = (
/obj/machinery/computer{
	dir = 8
	},
/obj/effect/decal/cleanable/dirt/dust,
/turf/open/floor/mineral/plastitanium,
/area/ruin/powered)
"m" = (
/obj/structure/punji_sticks,
/obj/structure/flora/junglebush,
/obj/effect/decal/remains/human,
/turf/open/floor/plating/dirt,
/area/ruin/unpowered)
"n" = (
/obj/structure/flora/junglebush/c,
/turf/open/floor/plating/dirt,
/area/ruin/unpowered)
"p" = (
/obj/machinery/porta_turret/syndicate/pod{
	dir = 10
	},
/turf/closed/wall/mineral/plastitanium/nodiagonal,
/area/ruin/powered)
"q" = (
/obj/structure/punji_sticks,
/obj/structure/flora/rock/jungle,
/obj/effect/decal/remains/human,
/turf/open/floor/plating/dirt,
/area/ruin/unpowered)
"r" = (
/obj/structure/table,
/obj/item/grenade/frag,
/obj/item/grenade/frag,
/obj/item/grenade/frag,
/turf/open/floor/mineral/plastitanium,
/area/ruin/powered)
"t" = (
/obj/structure/window/plasma/reinforced/plastitanium,
/obj/structure/grille,
/turf/open/floor/plating,
/area/ruin/powered)
"u" = (
/obj/machinery/porta_turret/syndicate/pod{
	dir = 6
	},
/turf/closed/wall/mineral/plastitanium/nodiagonal,
/area/template_noop)
"v" = (
/obj/structure/flora/junglebush/large,
/turf/open/floor/plating/dirt,
/area/ruin/unpowered)
"x" = (
/obj/effect/decal/cleanable/dirt/dust,
/turf/closed/wall/mineral/plastitanium/nodiagonal,
/area/ruin/powered)
"y" = (
/obj/structure/chair/plastic{
	dir = 4
	},
/turf/open/floor/mineral/plastitanium,
/area/ruin/powered)
"A" = (
/obj/effect/decal/cleanable/dirt/dust,
/obj/structure/table,
/obj/item/kitchen/knife/combat,
/obj/effect/decal/cleanable/dirt/dust,
/turf/open/floor/mineral/plastitanium,
/area/ruin/powered)
"C" = (
/obj/structure/table,
/obj/item/clothing/gloves/combat,
/obj/item/clothing/shoes/combat,
/obj/item/clothing/mask/gas/syndicate,
/turf/open/floor/mineral/plastitanium,
/area/ruin/powered)
"E" = (
/obj/structure/punji_sticks,
/obj/structure/flora/ausbushes/fernybush,
/obj/effect/decal/cleanable/blood/gibs/limb,
/turf/open/floor/plating/dirt,
/area/ruin/unpowered)
"F" = (
/obj/structure/rack,
/obj/item/stack/sheet/mineral/plasma,
/obj/effect/decal/cleanable/dirt/dust,
/turf/open/floor/mineral/plastitanium,
/area/ruin/powered)
"G" = (
/mob/living/simple_animal/hostile/syndicate/ranged/smg/pilot,
/obj/structure/sign/poster/contraband/power{
	pixel_x = 32
	},
/turf/open/floor/mineral/plastitanium,
/area/ruin/powered)
"H" = (
/obj/structure/punji_sticks,
/obj/structure/flora/ausbushes/fullgrass,
/turf/open/floor/plating/dirt,
/area/ruin/unpowered)
"J" = (
/obj/structure/punji_sticks,
/obj/structure/flora/ausbushes/fullgrass,
/obj/effect/decal/remains/human,
/turf/open/floor/plating/dirt,
/area/ruin/unpowered)
"K" = (
/obj/machinery/computer{
	dir = 1
	},
/turf/open/floor/mineral/plastitanium,
/area/ruin/powered)
"N" = (
/obj/structure/punji_sticks,
/obj/structure/flora/ausbushes/lavendergrass,
/obj/effect/decal/cleanable/blood/gibs/up,
/turf/open/floor/plating/dirt,
/area/ruin/unpowered)
"S" = (
/obj/effect/decal/cleanable/dirt/dust,
/turf/open/floor/mineral/plastitanium,
/area/ruin/powered)
"T" = (
/obj/structure/punji_sticks,
/obj/structure/flora/ausbushes/lavendergrass,
/obj/effect/decal/cleanable/blood/gibs/torso,
/turf/open/floor/plating/dirt,
/area/ruin/unpowered)
"U" = (
/obj/machinery/door/airlock/hatch,
/obj/effect/decal/cleanable/dirt/dust,
/turf/open/floor/plating,
/area/ruin/powered)
"V" = (
/turf/open/floor/mineral/plastitanium,
/area/ruin/powered)
"W" = (
/obj/structure/flora/tree/jungle,
/turf/open/floor/plating/dirt,
/area/ruin/unpowered)
"X" = (
/obj/machinery/light/broken{
	dir = 1
	},
/obj/structure/chair/plastic,
/mob/living/simple_animal/hostile/syndicate/ranged,
/turf/open/floor/mineral/plastitanium,
/area/ruin/powered)
"Z" = (
/obj/machinery/light,
/turf/open/floor/mineral/plastitanium,
/area/ruin/powered)

(1,1,1) = {"
a
a
J
g
H
m
a
a
a
"}
(2,1,1) = {"
a
a
b
t
t
t
p
a
a
"}
(3,1,1) = {"
a
b
c
k
F
i
b
b
a
"}
(4,1,1) = {"
W
b
j
S
S
S
C
t
T
"}
(5,1,1) = {"
v
U
S
Z
b
X
K
t
q
"}
(6,1,1) = {"
n
b
G
V
y
S
A
t
a
"}
(7,1,1) = {"
a
b
x
r
l
e
b
b
a
"}
(8,1,1) = {"
a
a
b
t
t
t
u
a
a
"}
(9,1,1) = {"
a
a
N
E
h
a
a
a
a
"}
