//MAP CONVERTED BY dmm2tgm.py THIS HEADER COMMENT PREVENTS RECONVERSION, DO NOT REMOVE
"aG" = (
/obj/structure/table_frame,
/obj/effect/decal/cleanable/glass,
/turf/open/floor/iron,
/area/ruin/powered)
"aH" = (
/obj/structure/table/wood/fancy,
/obj/machinery/chem_dispenser/drinks/beer{
	dir = 8
	},
/turf/open/floor/wood/tile,
/area/ruin/powered)
"aW" = (
/obj/structure/alien/weeds/node,
/turf/open/floor/iron,
/area/ruin/powered)
"by" = (
/obj/effect/decal/cleanable/blood/old,
/turf/open/floor/carpet/nanoweave/beige,
/area/ruin/powered)
"bB" = (
/obj/structure/alien/resin/wall,
/turf/open/floor/wood/tile,
/area/ruin/powered)
"ce" = (
/obj/effect/decal/cleanable/blood/old,
/obj/effect/decal/cleanable/glass,
/obj/structure/alien/resin/wall,
/turf/open/floor/iron,
/area/ruin/powered)
"cj" = (
/obj/structure/alien/egg,
/mob/living/simple_animal/hostile/alien/queen/large,
/turf/open/floor/iron,
/area/ruin/powered)
"cO" = (
/obj/structure/alien/resin/wall,
/turf/open/floor/carpet/nanoweave/blue,
/area/ruin/powered)
"cS" = (
/obj/effect/decal/cleanable/glass,
/obj/item/shard,
/obj/structure/alien/resin/wall,
/obj/item/ammo_casing/spent,
/turf/open/floor/iron,
/area/ruin/powered)
"dj" = (
/obj/structure/alien/weeds/node,
/obj/effect/decal/cleanable/blood/old,
/obj/effect/decal/cleanable/glass,
/obj/item/ammo_casing/spent,
/obj/item/ammo_casing/spent,
/turf/open/floor/carpet/nanoweave/red,
/area/ruin/powered)
"dG" = (
/obj/effect/decal/cleanable/blood/old,
/obj/item/clothing/head/solgov,
/turf/open/floor/plating/dirt,
/area/ruin/powered)
"eA" = (
/obj/structure/flora/ausbushes/pointybush,
/turf/open/floor/plating/dirt,
/area/ruin/powered)
"eB" = (
/obj/structure/flora/ausbushes/reedbush,
/turf/open/floor/plating/dirt/jungle,
/area/ruin/powered)
"eG" = (
/obj/machinery/vending/boozeomat,
/turf/open/floor/wood/tile,
/area/ruin/powered)
"fj" = (
/obj/structure/mecha_wreckage/ripley,
/obj/effect/decal/cleanable/glass,
/turf/open/floor/iron,
/area/ruin/powered)
"fZ" = (
/obj/structure/flora/ausbushes/grassybush,
/turf/open/floor/plating/dirt/jungle,
/area/ruin/powered)
"gb" = (
/mob/living/simple_animal/hostile/alien,
/turf/open/floor/iron,
/area/ruin/powered)
"gF" = (
/obj/effect/decal/cleanable/xenoblood/xgibs/larva/body,
/obj/structure/alien/resin/wall,
/turf/open/floor/iron,
/area/ruin/powered)
"gU" = (
/obj/effect/decal/remains/xeno,
/obj/item/ammo_casing/spent,
/turf/open/floor/carpet/nanoweave/blue,
/area/ruin/powered)
"hu" = (
/obj/structure/alien/weeds/node,
/turf/open/floor/wood/tile,
/area/ruin/powered)
"hZ" = (
/obj/machinery/door/airlock/solgov{
	name = "Security Post"
	},
/obj/item/ammo_casing/spent,
/obj/item/ammo_casing/spent,
/obj/item/ammo_casing/spent,
/turf/open/floor/iron/dark/smooth_half,
/area/ruin/powered)
"iF" = (
/turf/closed/mineral/random/jungle,
/area/ruin/powered)
"jI" = (
/obj/structure/alien/resin/wall,
/turf/open/floor/carpet/nanoweave/beige,
/area/ruin/powered)
"kd" = (
/obj/machinery/door/airlock/solgov/glass{
	name = "SolGov Research Post"
	},
/turf/open/floor/iron/dark/smooth_half,
/area/ruin/powered)
"ko" = (
/obj/effect/decal/cleanable/glass,
/obj/item/shard,
/obj/structure/grille/broken,
/obj/item/ammo_casing/spent,
/turf/open/floor/plating,
/area/ruin/powered)
"lh" = (
/turf/open/floor/iron,
/area/ruin/powered)
"lS" = (
/obj/item/clothing/glasses/night,
/obj/effect/decal/cleanable/glass,
/obj/structure/table_frame,
/turf/open/floor/carpet/nanoweave/red,
/area/ruin/powered)
"mc" = (
/mob/living/simple_animal/hostile/alien/warrior,
/turf/open/floor/iron,
/area/ruin/powered)
"mW" = (
/obj/effect/decal/cleanable/xenoblood/xgibs/larva/body,
/turf/open/floor/iron,
/area/ruin/powered)
"mY" = (
/obj/structure/alien/egg,
/obj/item/ammo_casing/spent,
/turf/open/floor/iron,
/area/ruin/powered)
"nn" = (
/turf/open/floor/plating/dirt,
/area/ruin/powered)
"nv" = (
/obj/structure/alien/resin/wall,
/obj/item/ammo_casing/spent,
/turf/open/floor/carpet/nanoweave/beige,
/area/ruin/powered)
"oB" = (
/obj/structure/table_frame,
/turf/open/floor/iron/dark/herringbone,
/area/ruin/powered)
"oH" = (
/mob/living/simple_animal/hostile/alien,
/turf/open/floor/iron/dark/herringbone,
/area/ruin/powered)
"oX" = (
/mob/living/simple_animal/hostile/alien/drone,
/obj/structure/table_frame,
/turf/open/floor/carpet/nanoweave/beige,
/area/ruin/powered)
"qK" = (
/obj/structure/flora/junglebush,
/turf/open/floor/plating/dirt/jungle,
/area/ruin/powered)
"rY" = (
/obj/structure/bed/nest,
/obj/effect/mob_spawn/human/corpse/cargo_tech,
/turf/open/floor/iron/dark/herringbone,
/area/ruin/powered)
"sw" = (
/obj/structure/bed/nest,
/obj/structure/alien/weeds/node,
/turf/open/floor/iron,
/area/ruin/powered)
"tZ" = (
/obj/effect/decal/cleanable/xenoblood,
/turf/open/floor/plating/dirt/jungle,
/area/ruin/powered)
"ul" = (
/obj/structure/alien/resin/wall,
/turf/open/floor/iron,
/area/ruin/powered)
"uo" = (
/obj/effect/decal/cleanable/glass,
/obj/item/clothing/head/crown,
/turf/open/floor/iron,
/area/ruin/powered)
"uR" = (
/obj/structure/chair/plastic{
	dir = 1
	},
/turf/open/floor/iron/dark/herringbone,
/area/ruin/powered)
"uU" = (
/obj/effect/decal/cleanable/xenoblood/xgibs/torso,
/obj/item/ammo_casing/spent,
/turf/open/floor/iron,
/area/ruin/powered)
"vg" = (
/obj/structure/bed/nest,
/turf/open/floor/iron,
/area/ruin/powered)
"vt" = (
/obj/structure/table,
/obj/item/toy/toy_xeno,
/obj/structure/alien/weeds/node,
/obj/item/research_notes/loot/genius,
/turf/open/floor/iron,
/area/ruin/powered)
"vW" = (
/obj/machinery/door/airlock/solgov{
	name = "Creature Containment"
	},
/turf/open/floor/iron/dark/smooth_half{
	dir = 8
	},
/area/ruin/powered)
"wc" = (
/obj/structure/alien/egg,
/obj/structure/window/reinforced/spawner{
	dir = 4
	},
/obj/effect/decal/cleanable/glass,
/turf/open/floor/iron,
/area/ruin/powered)
"wg" = (
/obj/effect/decal/cleanable/blood/old,
/obj/structure/chair/plastic{
	dir = 1
	},
/turf/open/floor/iron/dark/herringbone,
/area/ruin/powered)
"wl" = (
/obj/structure/bed/nest,
/obj/item/research_notes/loot/genius,
/turf/open/floor/iron/dark/herringbone,
/area/ruin/powered)
"wt" = (
/obj/item/clothing/head/solgov,
/obj/effect/turf_decal/siding/wood{
	dir = 8
	},
/obj/structure/table/wood,
/turf/open/floor/wood/tile,
/area/ruin/powered)
"xY" = (
/obj/structure/bed/nest,
/turf/open/floor/iron/dark/herringbone,
/area/ruin/powered)
"ya" = (
/obj/effect/decal/cleanable/xenoblood/xgibs/larva,
/turf/open/floor/plating/dirt/jungle,
/area/ruin/powered)
"yn" = (
/obj/effect/decal/cleanable/glass,
/mob/living/simple_animal/hostile/alien/praetorian,
/obj/item/ammo_casing/spent,
/obj/item/ammo_casing/spent,
/turf/open/floor/iron,
/area/ruin/powered)
"yr" = (
/obj/effect/decal/cleanable/blood/old,
/obj/item/gun/ballistic/automatic/pistol/solgov,
/obj/item/ammo_casing/spent,
/turf/open/floor/carpet/nanoweave/blue,
/area/ruin/powered)
"yF" = (
/obj/effect/decal/cleanable/glass,
/obj/structure/grille/broken,
/obj/item/ammo_casing/spent,
/turf/open/floor/plating,
/area/ruin/powered)
"yG" = (
/turf/open/floor/wood/tile,
/area/ruin/powered)
"yV" = (
/obj/machinery/door/airlock/solgov{
	name = "Employee Area"
	},
/turf/open/floor/iron/dark/smooth_half{
	dir = 8
	},
/area/ruin/powered)
"ze" = (
/obj/effect/decal/cleanable/glass,
/obj/item/ammo_casing/spent,
/turf/open/floor/iron,
/area/ruin/powered)
"zi" = (
/obj/effect/spawner/structure/window/reinforced,
/turf/open/floor/plating,
/area/ruin/powered)
"zv" = (
/obj/effect/decal/cleanable/glass,
/obj/structure/table_frame,
/turf/open/floor/iron,
/area/ruin/powered)
"zy" = (
/turf/closed/wall/r_wall,
/area/ruin/powered)
"zz" = (
/obj/effect/decal/remains/xeno/larva,
/obj/structure/window/reinforced/spawner,
/obj/effect/decal/cleanable/glass,
/turf/open/floor/iron,
/area/ruin/powered)
"zF" = (
/obj/item/ammo_casing/spent,
/turf/open/floor/iron/dark/herringbone,
/area/ruin/powered)
"Ab" = (
/obj/item/ammo_casing/spent,
/turf/open/floor/iron,
/area/ruin/powered)
"AC" = (
/obj/item/desk_flag/solgov,
/obj/effect/turf_decal/siding/wood{
	dir = 8
	},
/obj/structure/table/wood,
/turf/open/floor/wood/tile,
/area/ruin/powered)
"AE" = (
/obj/item/clothing/head/helmet/riot,
/obj/item/shield/riot,
/obj/effect/decal/cleanable/glass,
/obj/structure/table,
/turf/open/floor/carpet/nanoweave/red,
/area/ruin/powered)
"AI" = (
/obj/structure/alien/weeds/node,
/obj/effect/decal/cleanable/glass,
/turf/open/floor/iron,
/area/ruin/powered)
"BT" = (
/obj/item/gun/ballistic/automatic/solar,
/obj/structure/table,
/turf/open/floor/iron,
/area/ruin/powered)
"Du" = (
/obj/structure/bed/nest,
/obj/effect/mob_spawn/human/corpse/solgov/infantry,
/turf/open/floor/iron,
/area/ruin/powered)
"DP" = (
/obj/effect/decal/cleanable/glass,
/obj/item/shard,
/turf/open/floor/iron,
/area/ruin/powered)
"Ee" = (
/obj/structure/bed/nest,
/obj/item/kitchen/knife/combat/survival,
/turf/open/floor/iron/dark/herringbone,
/area/ruin/powered)
"EC" = (
/obj/structure/bed/nest,
/obj/effect/spawner/lootdrop/maintenance/two,
/turf/open/floor/iron,
/area/ruin/powered)
"ES" = (
/obj/item/ammo_casing/spent,
/obj/item/ammo_casing/spent,
/turf/open/floor/iron,
/area/ruin/powered)
"Fe" = (
/turf/open/floor/iron/dark/herringbone,
/area/ruin/powered)
"FA" = (
/obj/structure/bed/nest,
/obj/item/clothing/head/helmet/space/eva,
/turf/open/floor/iron/dark/herringbone,
/area/ruin/powered)
"Gk" = (
/obj/effect/decal/cleanable/blood/old,
/obj/effect/decal/cleanable/glass,
/obj/structure/table,
/obj/item/research_notes/loot/genius,
/obj/item/ammo_casing/spent,
/turf/open/floor/carpet/nanoweave/red,
/area/ruin/powered)
"Go" = (
/obj/effect/decal/cleanable/blood/old,
/obj/structure/table_frame,
/turf/open/floor/iron,
/area/ruin/powered)
"Gt" = (
/mob/living/simple_animal/hostile/alien/sentinel,
/obj/effect/decal/cleanable/glass,
/obj/item/ammo_casing/spent,
/turf/open/floor/iron,
/area/ruin/powered)
"Hh" = (
/mob/living/simple_animal/hostile/alien/drone,
/obj/item/ammo_casing/spent,
/obj/item/ammo_casing/spent,
/turf/open/floor/iron/dark/herringbone,
/area/ruin/powered)
"Hs" = (
/obj/effect/decal/cleanable/glass,
/obj/item/shard,
/obj/item/ammo_casing/spent,
/turf/open/floor/iron,
/area/ruin/powered)
"Hz" = (
/obj/structure/alien/egg/burst,
/turf/open/floor/iron,
/area/ruin/powered)
"HI" = (
/obj/machinery/dish_drive,
/obj/effect/turf_decal/siding/wood{
	dir = 8
	},
/obj/structure/table/wood,
/turf/open/floor/wood/tile,
/area/ruin/powered)
"Is" = (
/obj/structure/bed/nest,
/obj/effect/mob_spawn/human/corpse/assistant,
/turf/open/floor/iron/dark/herringbone,
/area/ruin/powered)
"II" = (
/turf/open/floor/plating/dirt/jungle,
/area/ruin/powered)
"IU" = (
/obj/structure/alien/weeds/node,
/obj/effect/decal/cleanable/xenoblood/xgibs/up,
/obj/item/ammo_casing/spent,
/turf/open/floor/carpet/nanoweave/beige,
/area/ruin/powered)
"Kl" = (
/obj/structure/alien/resin/wall,
/obj/item/ammo_casing/spent,
/turf/open/floor/iron,
/area/ruin/powered)
"KR" = (
/obj/structure/table/wood/fancy,
/obj/item/reagent_containers/food/drinks/bottle/champagne,
/turf/open/floor/wood/tile,
/area/ruin/powered)
"Lg" = (
/obj/structure/alien/resin/wall,
/turf/open/floor/iron/dark/herringbone,
/area/ruin/powered)
"Lh" = (
/mob/living/simple_animal/hostile/alien/drone,
/obj/structure/table_frame,
/turf/open/floor/iron,
/area/ruin/powered)
"Ln" = (
/obj/structure/alien/weeds/node,
/obj/item/ammo_casing/spent,
/turf/open/floor/iron,
/area/ruin/powered)
"MJ" = (
/obj/effect/decal/remains/human,
/turf/open/floor/iron/dark/herringbone,
/area/ruin/powered)
"Ne" = (
/obj/structure/alien/weeds/node,
/mob/living/simple_animal/hostile/alien,
/turf/open/floor/iron/dark/herringbone,
/area/ruin/powered)
"NB" = (
/obj/structure/alien/weeds/node,
/obj/effect/decal/cleanable/xenoblood/xgibs/larva/body,
/obj/item/ammo_casing/spent,
/turf/open/floor/carpet/nanoweave/blue,
/area/ruin/powered)
"NK" = (
/obj/effect/decal/cleanable/glass,
/turf/open/floor/iron,
/area/ruin/powered)
"Qu" = (
/obj/structure/chair/plastic{
	dir = 8
	},
/turf/open/floor/iron/dark/herringbone,
/area/ruin/powered)
"QT" = (
/obj/structure/chair/plastic{
	dir = 4
	},
/turf/open/floor/iron/dark/herringbone,
/area/ruin/powered)
"RG" = (
/obj/structure/bed/nest,
/obj/effect/mob_spawn/human/corpse/solgov/officer,
/turf/open/floor/carpet/nanoweave/red,
/area/ruin/powered)
"TB" = (
/obj/effect/decal/cleanable/glass,
/turf/open/floor/carpet/nanoweave/red,
/area/ruin/powered)
"TS" = (
/obj/structure/bed/nest,
/obj/effect/mob_spawn/human/corpse/assistant,
/turf/open/floor/carpet/nanoweave/beige,
/area/ruin/powered)
"TY" = (
/obj/structure/flora/junglebush/large,
/turf/open/floor/plating/dirt/jungle,
/area/ruin/powered)
"Uo" = (
/obj/effect/decal/cleanable/glass,
/obj/structure/alien/resin/wall,
/obj/item/ammo_casing/spent,
/turf/open/floor/iron,
/area/ruin/powered)
"UV" = (
/obj/effect/decal/cleanable/blood/old,
/turf/open/floor/wood/tile,
/area/ruin/powered)
"VK" = (
/obj/structure/flora/tree/jungle/small,
/turf/open/floor/plating/dirt/jungle,
/area/ruin/powered)
"VT" = (
/obj/structure/table/wood/fancy,
/obj/machinery/chem_dispenser/drinks{
	dir = 8
	},
/turf/open/floor/wood/tile,
/area/ruin/powered)
"Wb" = (
/turf/template_noop,
/area/template_noop)
"Wj" = (
/obj/structure/flora/tree/jungle,
/turf/open/floor/plating/dirt/jungle,
/area/ruin/powered)
"WZ" = (
/obj/effect/decal/cleanable/glass,
/obj/item/shard,
/obj/item/ammo_casing/spent,
/obj/item/ammo_casing/spent,
/obj/item/ammo_casing/spent,
/turf/open/floor/iron,
/area/ruin/powered)
"XR" = (
/obj/effect/decal/cleanable/blood/splatter,
/turf/open/floor/plating/dirt,
/area/ruin/powered)
"Yq" = (
/obj/structure/flora/ausbushes/stalkybush,
/turf/open/floor/plating/dirt/jungle,
/area/ruin/powered)
"YM" = (
/obj/structure/alien/weeds/node,
/turf/open/floor/iron/dark/herringbone,
/area/ruin/powered)
"Zp" = (
/obj/item/bodypart/chest/larva,
/obj/structure/table_frame,
/obj/item/ammo_casing/spent,
/obj/item/ammo_casing/spent,
/obj/item/ammo_casing/spent,
/turf/open/floor/iron,
/area/ruin/powered)
"ZL" = (
/obj/effect/decal/cleanable/glass,
/obj/structure/table,
/obj/item/research_notes/loot/genius,
/turf/open/floor/iron,
/area/ruin/powered)
"ZU" = (
/obj/effect/turf_decal/siding/wood{
	dir = 8
	},
/turf/open/floor/wood/tile,
/area/ruin/powered)

(1,1,1) = {"
Wb
Wb
Wb
iF
iF
iF
II
II
tZ
eB
Wb
Wb
Wb
Wb
Wb
"}
(2,1,1) = {"
iF
iF
iF
iF
iF
iF
iF
Yq
II
Wj
II
Wb
Wb
Wb
Wb
"}
(3,1,1) = {"
iF
zy
zy
zy
zy
zy
zy
zy
zy
II
II
II
Wb
Wb
Wb
"}
(4,1,1) = {"
iF
zy
BT
Hz
zz
ZL
Go
vg
zy
ya
TY
II
Wb
Wb
Wb
"}
(5,1,1) = {"
iF
zy
cj
uo
Hs
yn
aW
Du
zy
II
II
II
fZ
Wb
Wb
"}
(6,1,1) = {"
iF
zy
wc
AI
ze
ce
zv
ul
zy
zy
zy
zy
II
II
Wb
"}
(7,1,1) = {"
iF
zy
aG
fj
NK
cS
Zp
Gt
ko
TB
lS
zy
II
qK
Wb
"}
(8,1,1) = {"
iF
zy
Lh
gF
mc
Kl
Uo
WZ
hZ
dj
RG
zy
eB
II
Yq
"}
(9,1,1) = {"
iF
zy
vt
ul
mY
mW
ul
DP
yF
Gk
AE
zy
nn
II
II
"}
(10,1,1) = {"
iF
zy
zy
zy
zy
vW
zy
zy
zy
zy
zy
zy
nn
VK
II
"}
(11,1,1) = {"
iF
zy
ul
ul
gb
lh
EC
ul
lh
lh
zi
nn
nn
nn
TY
"}
(12,1,1) = {"
iF
zy
lh
cO
cO
gU
NB
cO
yr
lh
kd
XR
nn
nn
II
"}
(13,1,1) = {"
iF
zy
sw
lh
ul
ES
Ab
uU
Ln
ul
zi
nn
dG
nn
eA
"}
(14,1,1) = {"
iF
zy
zy
zy
zy
yV
zy
zy
zy
zy
zy
zy
zy
zy
II
"}
(15,1,1) = {"
iF
iF
zy
FA
Fe
Hh
Lg
QT
xY
Lg
uR
Fe
xY
zy
Yq
"}
(16,1,1) = {"
Wb
iF
zy
Ee
YM
jI
nv
oX
TS
jI
wg
Ne
wl
zy
iF
"}
(17,1,1) = {"
Wb
iF
zy
rY
uR
jI
by
IU
jI
jI
oB
MJ
Is
zy
iF
"}
(18,1,1) = {"
Wb
iF
zy
zy
oB
Qu
Fe
oH
zF
Fe
Fe
zy
zy
zy
iF
"}
(19,1,1) = {"
Wb
iF
iF
zy
zy
zy
zy
ZU
AC
wt
HI
zy
iF
iF
iF
"}
(20,1,1) = {"
Wb
Wb
iF
iF
iF
iF
zy
bB
bB
UV
yG
zy
iF
iF
iF
"}
(21,1,1) = {"
Wb
Wb
iF
iF
iF
iF
zy
eG
hu
yG
yG
zy
iF
iF
Wb
"}
(22,1,1) = {"
Wb
Wb
Wb
iF
iF
iF
zy
zy
KR
VT
aH
zy
iF
iF
Wb
"}
(23,1,1) = {"
Wb
Wb
Wb
Wb
iF
iF
iF
zy
zy
zy
zy
zy
iF
iF
Wb
"}
(24,1,1) = {"
Wb
Wb
Wb
Wb
Wb
Wb
iF
iF
iF
iF
iF
iF
iF
Wb
Wb
"}
(25,1,1) = {"
Wb
Wb
Wb
Wb
Wb
Wb
Wb
Wb
Wb
Wb
Wb
Wb
Wb
Wb
Wb
"}
