//MAP CONVERTED BY dmm2tgm.py THIS HEADER COMMENT PREVENTS RECONVERSION, DO NOT REMOVE
"c" = (
/mob/living/carbon/monkey/angry,
/obj/item/spear/bonespear,
/turf/open/floor/plating/dirt/jungle/dark,
/area/template_noop)
"m" = (
/obj/structure/flora/rock/jungle,
/turf/open/floor/plating/grass/jungle,
/area/template_noop)
"s" = (
/obj/structure/flora/ausbushes/leafybush,
/turf/open/floor/plating/grass/jungle,
/area/template_noop)
"u" = (
/obj/structure/flora/ausbushes/fullgrass,
/turf/open/floor/plating/grass/jungle,
/area/template_noop)
"w" = (
/obj/structure/flora/ausbushes/grassybush,
/turf/open/floor/plating/grass/jungle,
/area/template_noop)
"x" = (
/obj/structure/flora/junglebush/b,
/turf/open/floor/plating/grass/jungle,
/area/template_noop)
"J" = (
/turf/open/floor/plating/dirt/jungle/dark,
/area/template_noop)
"K" = (
/obj/structure/flora/junglebush/large,
/turf/open/floor/plating/grass/jungle,
/area/template_noop)
"L" = (
/obj/structure/flora/junglebush,
/turf/open/floor/plating/grass/jungle,
/area/template_noop)
"M" = (
/turf/open/floor/plating/grass/jungle,
/area/template_noop)
"N" = (
/obj/structure/bonfire/prelit,
/turf/open/floor/plating/dirt/jungle/dark,
/area/template_noop)
"Q" = (
/obj/machinery/washing_machine{
	color = "#222222";
	desc = "It's a washing machine.";
	name = "obelisk of enlightenment"
	},
/turf/open/floor/plating/dirt/jungle/dark,
/area/template_noop)
"S" = (
/mob/living/carbon/monkey/angry,
/turf/open/floor/plating/dirt/jungle/dark,
/area/template_noop)

(1,1,1) = {"
M
M
u
M
M
M
M
K
J
J
"}
(2,1,1) = {"
M
M
M
M
m
M
J
M
J
J
"}
(3,1,1) = {"
s
M
w
J
J
J
J
s
M
J
"}
(4,1,1) = {"
u
M
J
J
J
J
J
S
L
M
"}
(5,1,1) = {"
M
M
Q
c
J
J
J
J
J
M
"}
(6,1,1) = {"
M
M
J
J
c
J
J
N
J
M
"}
(7,1,1) = {"
M
M
M
J
J
J
J
J
S
m
"}
(8,1,1) = {"
J
M
K
u
M
J
S
J
M
M
"}
(9,1,1) = {"
J
J
M
M
m
M
x
J
M
u
"}
(10,1,1) = {"
J
J
s
M
M
M
M
M
x
M
"}
