//MAP CONVERTED BY dmm2tgm.py THIS HEADER COMMENT PREVENTS RECONVERSION, DO NOT REMOVE
"cv" = (
/obj/machinery/button,
/obj/structure/cable,
/turf/closed/indestructible/reinforced,
/area/ruin/powered)
"cD" = (
/obj/effect/decal/cleanable/wrapping,
/obj/effect/decal/cleanable/plasma,
/obj/effect/decal/cleanable/blood/old,
/turf/open/floor/plating,
/area/ruin/powered)
"dR" = (
/obj/effect/decal/cleanable/robot_debris/old,
/obj/effect/decal/cleanable/blood/old,
/turf/open/floor/iron,
/area/ruin/powered)
"eD" = (
/obj/structure/flora/junglebush/c,
/turf/open/floor/plating/dirt,
/area/ruin/unpowered)
"eS" = (
/obj/structure/flora/ausbushes/fullgrass,
/turf/open/floor/plating/dirt,
/area/ruin/unpowered)
"gA" = (
/turf/template_noop,
/area/template_noop)
"iV" = (
/obj/structure/flora/grass/jungle,
/turf/open/floor/plating/dirt,
/area/ruin/unpowered)
"jb" = (
/obj/structure/closet/firecloset,
/turf/open/floor/iron,
/area/ruin/powered)
"jx" = (
/obj/effect/decal/cleanable/plasma,
/obj/effect/decal/cleanable/oil/slippery,
/turf/open/floor/plating,
/area/ruin/powered)
"jB" = (
/obj/structure/flora/tree/jungle/small,
/turf/open/floor/plating/dirt,
/area/ruin/unpowered)
"jZ" = (
/obj/structure/flora/ausbushes/reedbush,
/turf/open/floor/plating/dirt,
/area/ruin/unpowered)
"ka" = (
/obj/structure/flora/junglebush,
/turf/open/floor/plating/dirt,
/area/ruin/unpowered)
"lk" = (
/obj/effect/decal/cleanable/dirt,
/turf/open/floor/plating,
/area/ruin/powered)
"lZ" = (
/obj/effect/decal/cleanable/plasma,
/obj/effect/decal/cleanable/oil/slippery,
/obj/effect/decal/cleanable/dirt,
/turf/open/floor/plating,
/area/ruin/powered)
"mb" = (
/obj/machinery/computer/mech_bay_power_console,
/obj/structure/cable{
	icon_state = "0-2"
	},
/turf/open/floor/iron,
/area/ruin/powered)
"nW" = (
/obj/effect/decal/cleanable/dirt,
/obj/structure/cable{
	icon_state = "2-8"
	},
/turf/open/floor/iron,
/area/ruin/powered)
"ph" = (
/obj/item/storage/toolbox/mechanical,
/obj/effect/decal/cleanable/plasma,
/obj/effect/decal/cleanable/dirt,
/turf/open/floor/plating,
/area/ruin/powered)
"ru" = (
/obj/structure/table/reinforced,
/obj/effect/decal/cleanable/dirt,
/obj/item/toy/figure/roboticist,
/turf/open/floor/iron,
/area/ruin/powered)
"sL" = (
/turf/closed/indestructible/reinforced,
/area/ruin/powered)
"ua" = (
/obj/effect/decal/cleanable/plasma,
/obj/effect/decal/cleanable/greenglow,
/obj/effect/decal/cleanable/dirt,
/obj/structure/cable{
	icon_state = "4-8"
	},
/obj/structure/cable{
	icon_state = "1-4"
	},
/turf/open/floor/plating,
/area/ruin/powered)
"va" = (
/obj/structure/flora/ausbushes/grassybush,
/turf/open/floor/plating/dirt,
/area/ruin/unpowered)
"xb" = (
/obj/machinery/power/port_gen/pacman,
/obj/effect/decal/cleanable/dirt,
/obj/structure/cable{
	icon_state = "0-8"
	},
/turf/open/floor/iron,
/area/ruin/powered)
"xt" = (
/obj/structure/flora/junglebush/b,
/turf/open/floor/plating/dirt,
/area/ruin/unpowered)
"xY" = (
/obj/effect/decal/cleanable/dirt,
/obj/structure/cable{
	icon_state = "1-4"
	},
/turf/open/floor/iron,
/area/ruin/powered)
"zf" = (
/obj/structure/cable{
	icon_state = "1-4"
	},
/turf/open/floor/plating,
/area/ruin/powered)
"zl" = (
/obj/structure/rack,
/obj/item/mecha_parts/mecha_equipment/weapon/energy/disabler,
/obj/item/mecha_parts/mecha_equipment/weapon/energy/plasma,
/obj/effect/decal/cleanable/cobweb,
/obj/effect/decal/cleanable/dirt,
/turf/open/floor/iron,
/area/ruin/powered)
"zC" = (
/obj/structure/reagent_dispensers/fueltank,
/obj/effect/decal/cleanable/cobweb/cobweb2,
/obj/effect/decal/cleanable/plasma,
/turf/open/floor/plating,
/area/ruin/powered)
"Ad" = (
/obj/effect/decal/remains/robot,
/turf/open/floor/iron,
/area/ruin/powered)
"Ap" = (
/obj/structure/cable{
	icon_state = "1-4"
	},
/turf/open/floor/iron,
/area/ruin/powered)
"EK" = (
/turf/open/floor/iron,
/area/ruin/powered)
"Gd" = (
/obj/effect/decal/cleanable/dirt,
/obj/structure/cable{
	icon_state = "1-2"
	},
/turf/open/floor/plating,
/area/ruin/powered)
"HM" = (
/obj/structure/closet/emcloset,
/turf/open/floor/iron,
/area/ruin/powered)
"Jd" = (
/obj/effect/decal/cleanable/oil/slippery,
/turf/open/floor/iron,
/area/ruin/powered)
"LS" = (
/obj/machinery/door/poddoor/shutters/preopen,
/turf/open/floor/plating,
/area/ruin/powered)
"LZ" = (
/obj/structure/reagent_dispensers/fueltank,
/obj/effect/decal/cleanable/dirt,
/turf/open/floor/iron,
/area/ruin/powered)
"Px" = (
/obj/effect/decal/cleanable/dirt,
/obj/effect/decal/cleanable/blood/old,
/turf/open/floor/iron,
/area/ruin/powered)
"Qm" = (
/obj/item/weldingtool/hugetank,
/obj/effect/decal/cleanable/dirt,
/turf/open/floor/iron,
/area/ruin/powered)
"Qo" = (
/obj/structure/rack,
/obj/item/mecha_parts/mecha_equipment/hydraulic_clamp,
/obj/item/mecha_parts/mecha_equipment/drill/diamonddrill,
/turf/open/floor/iron,
/area/ruin/powered)
"QT" = (
/obj/structure/table/reinforced,
/obj/effect/decal/cleanable/dirt,
/obj/item/clothing/under/rank/rnd/roboticist,
/turf/open/floor/iron,
/area/ruin/powered)
"SG" = (
/obj/effect/decal/remains/human,
/obj/structure/cable{
	icon_state = "4-8"
	},
/turf/open/floor/iron,
/area/ruin/powered)
"UC" = (
/obj/structure/chair/plastic{
	dir = 4
	},
/turf/open/floor/iron,
/area/ruin/powered)
"UI" = (
/turf/open/floor/plating,
/area/ruin/powered)
"UT" = (
/obj/mecha/working/ripley,
/turf/open/floor/iron,
/area/ruin/powered)
"Vj" = (
/obj/structure/flora/ausbushes/sparsegrass,
/obj/effect/decal/remains/human,
/turf/open/floor/plating/dirt,
/area/ruin/unpowered)
"VH" = (
/obj/machinery/mech_bay_recharge_port,
/obj/structure/cable{
	icon_state = "0-2"
	},
/turf/open/floor/iron,
/area/ruin/powered)
"Wg" = (
/obj/structure/mecha_wreckage/durand,
/turf/open/floor/iron,
/area/ruin/powered)
"WW" = (
/obj/machinery/light/floor,
/turf/open/floor/iron,
/area/ruin/powered)
"Xv" = (
/obj/machinery/door/poddoor/shutters,
/turf/open/floor/plating,
/area/ruin/powered)
"Xy" = (
/obj/effect/decal/cleanable/robot_debris,
/obj/structure/cable{
	icon_state = "2-8"
	},
/turf/open/floor/plating,
/area/ruin/powered)
"XF" = (
/obj/effect/decal/cleanable/plasma,
/obj/effect/decal/cleanable/dirt,
/obj/structure/mecha_wreckage/ripley/mkii,
/turf/open/floor/plating,
/area/ruin/powered)
"Yi" = (
/obj/effect/decal/cleanable/plasma,
/obj/structure/closet/crate/secure/plasma,
/turf/open/floor/plating,
/area/ruin/powered)
"YQ" = (
/obj/structure/table/reinforced,
/turf/open/floor/iron,
/area/ruin/powered)
"Zc" = (
/obj/structure/mecha_wreckage/marauder,
/turf/open/floor/iron,
/area/ruin/powered)

(1,1,1) = {"
gA
gA
gA
gA
jB
iV
Vj
jZ
"}
(2,1,1) = {"
sL
sL
sL
sL
sL
sL
sL
xt
"}
(3,1,1) = {"
sL
zl
HM
Zc
jb
XF
sL
eS
"}
(4,1,1) = {"
sL
Qo
ph
dR
UI
lk
cv
eD
"}
(5,1,1) = {"
sL
Wg
Ad
jx
UI
Jd
LS
va
"}
(6,1,1) = {"
sL
VH
zf
lk
lk
EK
LS
ka
"}
(7,1,1) = {"
sL
UT
SG
WW
UI
lk
Xv
jB
"}
(8,1,1) = {"
sL
mb
ua
lZ
UI
Px
Xv
gA
"}
(9,1,1) = {"
sL
Qm
nW
Gd
xY
Yi
Xv
gA
"}
(10,1,1) = {"
sL
LZ
cD
UC
Xy
Ap
sL
gA
"}
(11,1,1) = {"
sL
zC
QT
YQ
ru
xb
sL
gA
"}
(12,1,1) = {"
sL
sL
sL
sL
sL
sL
sL
gA
"}
