//MAP CONVERTED BY dmm2tgm.py THIS HEADER COMMENT PREVENTS RECONVERSION, DO NOT REMOVE
"aM" = (
/obj/structure/table,
/obj/item/disk/data,
/obj/item/disk/data,
/obj/item/disk/data,
/obj/item/disk/data,
/obj/item/disk/data,
/obj/effect/turf_decal/siding/thinplating/corner,
/turf/open/floor/iron/herringbone,
/area/ship/bridge)
"aP" = (
/obj/item/kirbyplants/fullysynthetic,
/turf/open/floor/iron/herringbone,
/area/ship/crew/canteen)
"bI" = (
/turf/closed/wall/r_wall,
/area/ship/crew/hydroponics)
"ce" = (
/obj/structure/chair/greyscale,
/turf/open/floor/carpet/green,
/area/ship/bridge)
"cX" = (
/obj/effect/turf_decal/siding/thinplating{
	dir = 4
	},
/obj/effect/turf_decal/siding/thinplating{
	dir = 8
	},
/obj/machinery/door/airlock/external/glass,
/turf/open/floor/iron/dark/smooth_half{
	dir = 1
	},
/area/ship/hallway)
"dJ" = (
/obj/structure/closet/crate/large,
/obj/item/clothing/suit/space/hardsuit/engine,
/obj/effect/turf_decal/corner/yellow/diagonal_centre,
/turf/open/floor/iron/diagonal,
/area/ship/engineering)
"dR" = (
/turf/closed/wall/r_wall,
/area/ship/engineering)
"ez" = (
/obj/structure/bed,
/obj/item/bedsheet/medical,
/turf/open/floor/iron/white/small,
/area/ship/crew/dorm)
"eQ" = (
/obj/machinery/washing_machine,
/turf/open/floor/wood,
/area/ship/crew/dorm)
"fM" = (
/obj/structure/chair/greyscale{
	dir = 8
	},
/turf/open/floor/carpet/green,
/area/ship/bridge)
"fR" = (
/obj/effect/gibspawner/xeno,
/turf/open/floor/iron/herringbone,
/area/ship/crew/canteen)
"gb" = (
/obj/structure/table,
/obj/item/plant_analyzer,
/obj/structure/cable{
	icon_state = "0-2"
	},
/turf/open/floor/iron/edge{
	dir = 1
	},
/area/ship/hallway)
"hl" = (
/obj/structure/cable{
	icon_state = "1-2"
	},
/obj/effect/decal/cleanable/blood/tracks,
/obj/effect/turf_decal/siding/thinplating{
	dir = 1
	},
/obj/effect/turf_decal/siding/thinplating,
/obj/machinery/door/airlock/command{
	name = "Communications Center"
	},
/turf/open/floor/iron/dark/smooth_half,
/area/ship/bridge)
"hm" = (
/obj/effect/decal/cleanable/glass,
/turf/open/floor/carpet/green,
/area/ship/bridge)
"ii" = (
/obj/structure/closet/secure_closet/hydroponics,
/obj/effect/turf_decal/corner/green{
	dir = 4
	},
/turf/open/floor/iron/edge,
/area/ship/hallway)
"ik" = (
/obj/structure/table,
/obj/machinery/photocopier/faxmachine,
/obj/effect/turf_decal/siding/thinplating{
	dir = 8
	},
/turf/open/floor/iron/herringbone,
/area/ship/bridge)
"iv" = (
/obj/machinery/telecomms/relay/preset/ruskie,
/obj/effect/turf_decal/siding/thinplating/corner{
	dir = 8
	},
/turf/open/floor/iron/herringbone,
/area/ship/bridge)
"iG" = (
/obj/machinery/vending/cigarette,
/turf/open/floor/iron/herringbone,
/area/ship/crew/canteen)
"jb" = (
/obj/effect/gibspawner/xeno,
/turf/open/floor/iron/white/small,
/area/ship/crew/dorm)
"jc" = (
/obj/machinery/seed_extractor,
/obj/effect/turf_decal/corner/green/diagonal,
/turf/open/floor/iron,
/area/ship/crew/hydroponics)
"jf" = (
/obj/machinery/computer{
	name = "old computer";
	dir = 1
	},
/obj/effect/turf_decal/siding/thinplating{
	dir = 1
	},
/turf/open/floor/iron/herringbone,
/area/ship/bridge)
"ji" = (
/obj/machinery/vending/hydroseeds,
/obj/effect/turf_decal/corner/green/diagonal,
/turf/open/floor/iron,
/area/ship/crew/hydroponics)
"js" = (
/obj/structure/cable{
	icon_state = "1-2"
	},
/obj/effect/decal/cleanable/blood/tracks,
/obj/effect/turf_decal/siding/thinplating,
/turf/open/floor/iron/herringbone,
/area/ship/bridge)
"jK" = (
/obj/effect/turf_decal/siding/thinplating{
	dir = 8
	},
/obj/effect/turf_decal/siding/thinplating{
	dir = 4
	},
/obj/machinery/door/airlock/external/glass,
/turf/open/floor/iron/dark/smooth_half{
	dir = 1
	},
/area/ship/hallway)
"jZ" = (
/obj/effect/decal/cleanable/blood/splatter,
/obj/item/gun/energy/laser/retro,
/obj/effect/turf_decal/dept/medical{
	dir = 8
	},
/obj/effect/mob_spawn/human/corpse{
	outfit = /datum/outfit/job/head_of_personnel/western
	},
/obj/effect/decal/cleanable/blood,
/turf/open/floor/wood,
/area/ship/crew/dorm)
"ke" = (
/obj/structure/cable{
	icon_state = "1-4"
	},
/obj/structure/cable{
	icon_state = "1-8"
	},
/obj/effect/decal/cleanable/blood/splatter,
/turf/open/floor/iron/herringbone,
/area/ship/crew/canteen)
"kj" = (
/obj/machinery/vending/sovietsoda,
/turf/open/floor/iron/herringbone,
/area/ship/crew/canteen)
"kG" = (
/turf/closed/wall/r_wall,
/area/ship/hallway)
"lb" = (
/obj/machinery/power/smes,
/obj/effect/turf_decal/corner/yellow/diagonal_centre,
/turf/open/floor/iron/diagonal,
/area/ship/engineering)
"lK" = (
/obj/machinery/hydroponics/constructable,
/obj/effect/turf_decal/corner/green/diagonal,
/turf/open/floor/iron,
/area/ship/crew/hydroponics)
"lO" = (
/obj/structure/cable{
	icon_state = "4-8"
	},
/obj/effect/turf_decal/corner/yellow/diagonal_centre,
/turf/open/floor/iron/diagonal,
/area/ship/engineering)
"mg" = (
/obj/structure/cable{
	icon_state = "1-2"
	},
/obj/machinery/door/airlock/public/glass{
	name = "Break Room"
	},
/obj/effect/turf_decal/siding/thinplating,
/obj/effect/turf_decal/siding/thinplating{
	dir = 1
	},
/turf/open/floor/iron/dark/smooth_half,
/area/ship/crew/canteen)
"mL" = (
/obj/structure/cable{
	icon_state = "1-2"
	},
/obj/effect/decal/cleanable/blood,
/obj/effect/turf_decal/corner/blue/half,
/turf/open/floor/iron/edge,
/area/ship/hallway)
"mN" = (
/obj/effect/gibspawner/xeno,
/obj/effect/turf_decal/corner/green/diagonal,
/turf/open/floor/iron,
/area/ship/crew/hydroponics)
"nl" = (
/obj/structure/cable{
	icon_state = "4-8"
	},
/obj/effect/decal/cleanable/xenoblood/xgibs,
/turf/open/floor/iron/herringbone,
/area/ship/crew/canteen)
"nF" = (
/obj/effect/decal/cleanable/glass,
/obj/item/shard,
/turf/open/floor/carpet/green,
/area/ship/bridge)
"nJ" = (
/obj/structure/flora/ausbushes/sparsegrass,
/turf/open/floor/grass,
/area/ruin/jungle)
"nQ" = (
/obj/machinery/power/apc,
/turf/closed/wall/r_wall,
/area/ship/engineering)
"nS" = (
/obj/structure/cable{
	icon_state = "1-4"
	},
/obj/effect/decal/cleanable/blood/tracks,
/turf/open/floor/carpet/green,
/area/ship/bridge)
"oc" = (
/obj/machinery/door/airlock/glass{
	name = "Hydroponics"
	},
/obj/effect/turf_decal/siding/thinplating{
	dir = 4
	},
/obj/effect/turf_decal/siding/thinplating{
	dir = 8
	},
/turf/open/floor/iron/dark/smooth_half{
	dir = 1
	},
/area/ship/crew/hydroponics)
"om" = (
/obj/effect/decal/cleanable/blood/tracks{
	dir = 10
	},
/obj/effect/decal/cleanable/blood/splatter,
/turf/open/floor/carpet/green,
/area/ship/bridge)
"oR" = (
/obj/structure/table,
/obj/item/storage/fancy/cigarettes/cigpack_robust,
/turf/open/floor/iron/white/small,
/area/ship/crew/dorm)
"pt" = (
/obj/structure/cable{
	icon_state = "0-2"
	},
/obj/structure/closet/crate/bin,
/obj/effect/turf_decal/siding/thinplating,
/turf/open/floor/iron/herringbone,
/area/ship/bridge)
"pM" = (
/turf/closed/wall/r_wall,
/area/ship/crew/canteen)
"qM" = (
/obj/structure/sign/poster/contraband/ambrosia_vulgaris,
/turf/closed/wall/r_wall,
/area/ship/crew/hydroponics)
"ru" = (
/obj/structure/cable{
	icon_state = "2-4"
	},
/obj/structure/cable{
	icon_state = "4-8"
	},
/obj/effect/decal/cleanable/blood/splatter,
/obj/effect/turf_decal/corner/green/diagonal,
/turf/open/floor/iron,
/area/ship/crew/hydroponics)
"sA" = (
/obj/effect/turf_decal/siding/thinplating/dark,
/obj/machinery/suit_storage_unit/standard_unit,
/turf/open/floor/iron/dark/small,
/area/ship/hallway)
"sK" = (
/obj/structure/closet/secure_closet/hydroponics,
/obj/effect/turf_decal/corner/blue{
	dir = 8
	},
/turf/open/floor/iron/edge,
/area/ship/hallway)
"sU" = (
/obj/structure/cable{
	icon_state = "4-8"
	},
/obj/effect/decal/cleanable/blood,
/obj/effect/mob_spawn/human/corpse{
	outfit = /datum/outfit/job/botanist
	},
/obj/effect/turf_decal/siding/thinplating{
	dir = 8
	},
/turf/open/floor/iron/herringbone,
/area/ship/bridge)
"tb" = (
/obj/structure/grille/broken,
/obj/effect/decal/cleanable/glass,
/turf/open/floor/plating,
/area/ship/bridge)
"uC" = (
/obj/structure/cable{
	icon_state = "4-8"
	},
/obj/effect/decal/cleanable/blood/splatter,
/turf/open/floor/wood,
/area/ship/crew/dorm)
"uK" = (
/obj/structure/flora/ausbushes/sparsegrass,
/obj/structure/flora/grass/jungle,
/turf/open/floor/grass,
/area/ruin/jungle)
"uM" = (
/obj/structure/cable{
	icon_state = "1-2"
	},
/obj/structure/cable{
	icon_state = "1-8"
	},
/turf/open/floor/carpet/green,
/area/ship/bridge)
"vo" = (
/obj/structure/cable{
	icon_state = "1-8"
	},
/obj/effect/turf_decal/corner/yellow/diagonal_centre,
/turf/open/floor/iron/diagonal,
/area/ship/engineering)
"wl" = (
/obj/structure/table,
/obj/item/storage/belt/utility,
/obj/effect/turf_decal/corner/yellow/diagonal_centre,
/turf/open/floor/iron/diagonal,
/area/ship/engineering)
"wP" = (
/obj/structure/table,
/obj/effect/turf_decal/siding/thinplating/corner{
	dir = 1
	},
/turf/open/floor/iron/herringbone,
/area/ship/bridge)
"wU" = (
/obj/structure/flora/ausbushes/grassybush,
/turf/open/floor/grass,
/area/ruin/jungle)
"xa" = (
/obj/effect/decal/cleanable/blood/splatter,
/turf/open/floor/iron/herringbone,
/area/ship/crew/canteen)
"yi" = (
/turf/open/floor/iron/herringbone,
/area/ship/crew/canteen)
"yt" = (
/obj/structure/cable{
	icon_state = "4-8"
	},
/obj/machinery/door/airlock/public/glass{
	name = "Dorms"
	},
/obj/effect/turf_decal/siding/wood{
	dir = 4
	},
/obj/effect/turf_decal/siding/thinplating{
	dir = 8
	},
/turf/open/floor/iron/dark/smooth_half{
	dir = 1
	},
/area/ship/crew/dorm)
"yR" = (
/obj/machinery/hydroponics/constructable,
/obj/effect/decal/cleanable/xenoblood,
/obj/effect/turf_decal/corner/green/diagonal,
/turf/open/floor/iron,
/area/ship/crew/hydroponics)
"yS" = (
/obj/structure/table,
/obj/item/storage/toolbox/mechanical,
/obj/item/storage/toolbox/electrical,
/turf/open/floor/iron/edge{
	dir = 1
	},
/area/ship/hallway)
"zm" = (
/obj/structure/cable{
	icon_state = "4-8"
	},
/obj/effect/mob_spawn/human/corpse{
	outfit = /datum/outfit/job/botanist
	},
/obj/effect/decal/cleanable/blood,
/turf/open/floor/iron/herringbone,
/area/ship/crew/canteen)
"zz" = (
/obj/structure/grille,
/obj/structure/window/reinforced/fulltile,
/turf/open/floor/plating,
/area/ship/crew/hydroponics)
"Aq" = (
/obj/structure/table,
/obj/item/paper_bin,
/obj/item/pen,
/obj/item/folder,
/obj/item/stamp,
/obj/effect/turf_decal/siding/thinplating{
	dir = 4
	},
/turf/open/floor/iron/herringbone,
/area/ship/bridge)
"AD" = (
/obj/structure/bed,
/obj/item/bedsheet/black,
/turf/open/floor/wood,
/area/ship/crew/dorm)
"AJ" = (
/obj/effect/turf_decal/siding/thinplating{
	dir = 8
	},
/turf/open/floor/iron/herringbone,
/area/ship/bridge)
"Cj" = (
/obj/structure/cable{
	icon_state = "1-8"
	},
/obj/effect/decal/cleanable/blood/splatter,
/turf/open/floor/iron,
/area/ship/hallway)
"CO" = (
/obj/machinery/power/apc,
/turf/closed/wall/r_wall,
/area/ship/crew/hydroponics)
"Dr" = (
/obj/effect/turf_decal/corner/green/diagonal,
/turf/open/floor/iron,
/area/ship/crew/hydroponics)
"DL" = (
/obj/machinery/power/port_gen/pacman,
/obj/structure/cable{
	icon_state = "0-2"
	},
/obj/effect/turf_decal/corner/yellow/diagonal_centre,
/turf/open/floor/iron/diagonal,
/area/ship/engineering)
"DS" = (
/obj/structure/closet/crate/bin,
/turf/open/floor/iron/herringbone,
/area/ship/crew/canteen)
"Ec" = (
/obj/structure/cable{
	icon_state = "4-8"
	},
/obj/effect/turf_decal/corner/yellow/diagonal_centre,
/obj/item/storage/toolbox/mechanical/old/clean,
/turf/open/floor/iron/diagonal,
/area/ship/engineering)
"Ei" = (
/obj/effect/turf_decal/corner/green,
/turf/open/floor/iron,
/area/ship/hallway)
"EJ" = (
/obj/structure/cable{
	icon_state = "0-8"
	},
/obj/effect/gibspawner/xeno,
/turf/open/floor/wood,
/area/ship/crew/dorm)
"EK" = (
/obj/structure/flora/ausbushes/sparsegrass,
/obj/effect/decal/cleanable/glass,
/obj/item/shard,
/turf/open/floor/grass,
/area/ruin/jungle)
"Fm" = (
/obj/effect/turf_decal/corner/green{
	dir = 6
	},
/turf/open/floor/iron,
/area/ship/hallway)
"Fv" = (
/turf/open/floor/iron/large,
/area/ship/hallway)
"FF" = (
/obj/effect/decal/cleanable/xenoblood,
/turf/open/floor/iron/herringbone,
/area/ship/crew/canteen)
"FG" = (
/obj/effect/turf_decal/siding/wood,
/obj/effect/turf_decal/siding/wood{
	dir = 1
	},
/obj/machinery/door/airlock/public/glass{
	name = "Dorms"
	},
/turf/open/floor/iron/dark/smooth_half,
/area/ship/crew/dorm)
"FN" = (
/obj/structure/cable{
	icon_state = "1-2"
	},
/obj/effect/turf_decal/corner/green/diagonal,
/turf/open/floor/iron,
/area/ship/crew/hydroponics)
"FZ" = (
/obj/structure/cable{
	icon_state = "4-8"
	},
/obj/effect/turf_decal/corner/green/diagonal,
/turf/open/floor/iron,
/area/ship/crew/hydroponics)
"Gq" = (
/obj/structure/table,
/obj/item/book/manual/hydroponics_pod_people,
/turf/open/floor/iron/edge{
	dir = 1
	},
/area/ship/hallway)
"Gx" = (
/obj/structure/cable{
	icon_state = "1-4"
	},
/obj/effect/decal/cleanable/blood/tracks{
	dir = 8
	},
/turf/open/floor/carpet/green,
/area/ship/bridge)
"GY" = (
/obj/effect/decal/cleanable/glass,
/obj/item/shard,
/obj/structure/table,
/obj/effect/turf_decal/siding/thinplating{
	dir = 1
	},
/turf/open/floor/iron/herringbone,
/area/ship/bridge)
"Hm" = (
/obj/structure/chair/greyscale{
	dir = 8
	},
/turf/open/floor/iron/herringbone,
/area/ship/crew/canteen)
"Hu" = (
/turf/open/floor/iron,
/area/ship/hallway)
"HQ" = (
/obj/effect/mob_spawn/human/corpse{
	outfit = /datum/outfit/job/engineer
	},
/obj/effect/decal/cleanable/blood,
/obj/effect/turf_decal/corner/yellow/diagonal_centre,
/turf/open/floor/iron/diagonal,
/area/ship/engineering)
"Ie" = (
/obj/structure/table,
/obj/machinery/plantgenes,
/obj/effect/turf_decal/corner/green/diagonal,
/turf/open/floor/iron,
/area/ship/crew/hydroponics)
"Ig" = (
/obj/structure/table,
/obj/item/clothing/glasses/meson,
/obj/effect/turf_decal/corner/yellow/diagonal_centre,
/turf/open/floor/iron/diagonal,
/area/ship/engineering)
"IG" = (
/obj/structure/closet/crate/large,
/obj/item/stack/sheet/metal/twenty,
/obj/item/stack/sheet/glass{
	amount = 20
	},
/obj/effect/turf_decal/corner/yellow/diagonal_centre,
/turf/open/floor/iron/diagonal,
/area/ship/engineering)
"IT" = (
/obj/machinery/power/apc,
/turf/closed/wall/r_wall,
/area/ship/crew/canteen)
"Ji" = (
/obj/structure/window/reinforced/fulltile,
/obj/structure/grille,
/turf/open/floor/plating,
/area/ship/crew/dorm)
"JU" = (
/obj/structure/cable{
	icon_state = "2-4"
	},
/turf/open/floor/iron,
/area/ship/hallway)
"Ke" = (
/obj/structure/cable{
	icon_state = "1-2"
	},
/obj/effect/gibspawner/xeno,
/turf/open/floor/iron,
/area/ship/hallway)
"Kn" = (
/obj/structure/sign/departments/botany,
/turf/closed/wall/r_wall,
/area/ship/crew/hydroponics)
"Kt" = (
/obj/structure/chair/greyscale{
	dir = 4
	},
/turf/open/floor/iron/herringbone,
/area/ship/crew/canteen)
"KE" = (
/obj/structure/cable{
	icon_state = "1-4"
	},
/obj/structure/cable{
	icon_state = "1-8"
	},
/turf/open/floor/iron/herringbone,
/area/ship/crew/canteen)
"Nk" = (
/obj/structure/table,
/obj/item/storage/box/donkpockets/donkpocketberry,
/obj/item/storage/box/donkpockets/donkpockethonk,
/turf/open/floor/iron/herringbone,
/area/ship/crew/canteen)
"Nn" = (
/turf/open/floor/iron/white/small,
/area/ship/crew/dorm)
"Np" = (
/obj/structure/grille/broken,
/obj/effect/decal/cleanable/glass,
/obj/item/shard,
/turf/open/floor/plating,
/area/ship/bridge)
"OX" = (
/obj/effect/turf_decal/corner/yellow/diagonal_centre,
/turf/open/floor/iron/diagonal,
/area/ship/engineering)
"Pm" = (
/obj/structure/sign/departments/engineering,
/turf/closed/wall/r_wall,
/area/ship/engineering)
"Pp" = (
/obj/structure/window/reinforced/fulltile,
/obj/structure/grille,
/turf/open/floor/plating,
/area/ship/crew/hydroponics)
"Pq" = (
/obj/effect/decal/cleanable/xenoblood,
/obj/effect/decal/cleanable/glass,
/turf/open/floor/carpet/green,
/area/ship/bridge)
"Qc" = (
/obj/structure/window/reinforced/fulltile,
/obj/structure/grille,
/turf/open/floor/plating,
/area/ship/bridge)
"Qg" = (
/obj/structure/cable{
	icon_state = "1-4"
	},
/obj/effect/turf_decal/corner/green/diagonal,
/turf/open/floor/iron,
/area/ship/crew/hydroponics)
"Qu" = (
/obj/effect/turf_decal/siding/thinplating{
	dir = 4
	},
/obj/effect/turf_decal/siding/thinplating{
	dir = 8
	},
/obj/machinery/door/airlock/command{
	name = "Communications Center"
	},
/turf/open/floor/iron/dark/smooth_half{
	dir = 1
	},
/area/ship/bridge)
"QJ" = (
/obj/structure/cable{
	icon_state = "4-8"
	},
/obj/effect/turf_decal/siding/thinplating{
	dir = 4
	},
/obj/effect/turf_decal/siding/thinplating{
	dir = 8
	},
/obj/machinery/door/airlock/engineering{
	name = "Engineering"
	},
/obj/effect/mapping_helpers/airlock/locked,
/turf/open/floor/iron/dark/smooth_half{
	dir = 1
	},
/area/ship/engineering)
"Rc" = (
/obj/structure/table,
/obj/effect/turf_decal/siding/thinplating,
/turf/open/floor/iron/herringbone,
/area/ship/bridge)
"Rj" = (
/obj/item/stack/sheet/mineral/plasma/twenty,
/obj/structure/closet/crate{
	name = "fuel crate"
	},
/obj/effect/turf_decal/corner/yellow/diagonal_centre,
/turf/open/floor/iron/diagonal,
/area/ship/engineering)
"Se" = (
/obj/structure/closet/secure_closet/personal,
/turf/open/floor/wood,
/area/ship/crew/dorm)
"Sh" = (
/obj/structure/flora/grass/jungle,
/turf/open/floor/grass,
/area/ruin/jungle)
"Sj" = (
/obj/effect/turf_decal/siding/wood{
	dir = 8
	},
/obj/machinery/door/airlock/medical{
	name = "First Aid Post"
	},
/obj/effect/turf_decal/siding/thinplating/light{
	dir = 4
	},
/turf/open/floor/iron/dark/smooth_half{
	dir = 1
	},
/area/ship/crew/dorm)
"Ss" = (
/obj/machinery/power/terminal{
	dir = 1
	},
/obj/structure/cable{
	icon_state = "0-4"
	},
/obj/structure/cable{
	icon_state = "0-8"
	},
/obj/effect/gibspawner/xeno,
/obj/effect/turf_decal/corner/yellow/diagonal_centre,
/turf/open/floor/iron/diagonal,
/area/ship/engineering)
"SB" = (
/obj/machinery/vending/hydronutrients,
/obj/structure/cable{
	icon_state = "0-2"
	},
/obj/effect/turf_decal/corner/green/diagonal,
/turf/open/floor/iron,
/area/ship/crew/hydroponics)
"SQ" = (
/obj/structure/cable{
	icon_state = "4-8"
	},
/turf/closed/wall/r_wall,
/area/ship/bridge)
"Uo" = (
/obj/structure/table,
/obj/machinery/microwave{
	pixel_y = 7
	},
/obj/structure/cable{
	icon_state = "0-2"
	},
/turf/open/floor/iron/herringbone,
/area/ship/crew/canteen)
"Vn" = (
/obj/machinery/computer{
	name = "old computer";
	dir = 4
	},
/obj/effect/turf_decal/siding/thinplating{
	dir = 4
	},
/turf/open/floor/iron/herringbone,
/area/ship/bridge)
"Vu" = (
/obj/machinery/power/apc,
/turf/closed/wall/r_wall,
/area/ship/crew/dorm)
"VH" = (
/obj/structure/cable{
	icon_state = "1-2"
	},
/turf/open/floor/iron/herringbone,
/area/ship/crew/canteen)
"Wo" = (
/obj/structure/sign/poster/contraband/donut_corp,
/turf/closed/wall/r_wall,
/area/ship/engineering)
"Ws" = (
/obj/machinery/power/apc,
/turf/closed/wall/r_wall,
/area/ship/hallway)
"WE" = (
/obj/structure/cable{
	icon_state = "4-8"
	},
/turf/open/floor/iron/herringbone,
/area/ship/crew/canteen)
"Xq" = (
/obj/machinery/power/apc,
/turf/closed/wall/r_wall,
/area/ship/bridge)
"XO" = (
/turf/closed/wall/r_wall,
/area/ship/bridge)
"Yc" = (
/obj/effect/mob_spawn/human/corpse{
	outfit = /datum/outfit/job/botanist
	},
/obj/effect/decal/cleanable/blood,
/obj/effect/turf_decal/corner/green/diagonal,
/turf/open/floor/iron,
/area/ship/crew/hydroponics)
"YI" = (
/obj/structure/closet/crate/medical,
/obj/item/storage/firstaid/regular,
/turf/open/floor/iron/white/small,
/area/ship/crew/dorm)
"YN" = (
/obj/structure/table,
/obj/item/toy/cards/deck/tarot,
/turf/open/floor/iron/herringbone,
/area/ship/crew/canteen)
"Zq" = (
/obj/machinery/suit_storage_unit/open,
/obj/effect/turf_decal/siding/thinplating/dark{
	dir = 1
	},
/turf/open/floor/iron/dark/small,
/area/ship/hallway)
"ZO" = (
/obj/structure/bed,
/obj/item/bedsheet/green,
/turf/open/floor/wood,
/area/ship/crew/dorm)
"ZU" = (
/turf/closed/wall/r_wall,
/area/ship/crew/dorm)

(1,1,1) = {"
wU
kG
kG
cX
kG
XO
Qc
XO
Qc
Qc
wU
Sh
"}
(2,1,1) = {"
Sh
kG
sA
Fv
Zq
XO
aM
Vn
Aq
Qc
Np
EK
"}
(3,1,1) = {"
kG
kG
kG
jK
kG
XO
Rc
fM
hm
Pq
tb
Np
"}
(4,1,1) = {"
kG
yS
JU
Ke
mL
hl
js
nS
om
nF
GY
Qc
"}
(5,1,1) = {"
Ws
gb
Cj
Hu
sK
Xq
pt
uM
Gx
ce
jf
XO
"}
(6,1,1) = {"
kG
Gq
Ei
Fm
ii
XO
iv
ik
sU
AJ
wP
Qc
"}
(7,1,1) = {"
kG
bI
Kn
oc
bI
XO
XO
XO
SQ
Qu
XO
XO
"}
(8,1,1) = {"
wU
qM
ji
Dr
Dr
lK
pM
iG
WE
fR
Kt
pM
"}
(9,1,1) = {"
Sh
CO
SB
Qg
Yc
yR
pM
kj
nl
yi
YN
pM
"}
(10,1,1) = {"
nJ
zz
lK
ru
FN
FN
mg
VH
KE
xa
Hm
pM
"}
(11,1,1) = {"
nJ
Pp
lK
FZ
Dr
lK
IT
Uo
ke
FF
aP
pM
"}
(12,1,1) = {"
Sh
zz
lK
FZ
mN
lK
pM
Nk
zm
DS
pM
pM
"}
(13,1,1) = {"
Sh
bI
jc
FZ
Ie
bI
ZU
ZU
yt
ZU
ZU
nJ
"}
(14,1,1) = {"
wU
dR
Pm
QJ
dR
dR
AD
FG
uC
Se
Ji
Sh
"}
(15,1,1) = {"
nJ
dR
wl
lO
IG
dR
ZU
Vu
EJ
Se
ZU
uK
"}
(16,1,1) = {"
Sh
dR
Ig
lO
dJ
dR
ZO
FG
jZ
eQ
Ji
Sh
"}
(17,1,1) = {"
Sh
dR
Rj
Ec
OX
dR
ZU
ZU
Sj
ZU
ZU
wU
"}
(18,1,1) = {"
Sh
dR
lb
Ss
HQ
Wo
ez
Nn
Nn
Ji
Sh
nJ
"}
(19,1,1) = {"
nJ
nQ
DL
vo
OX
dR
oR
jb
YI
Ji
nJ
Sh
"}
(20,1,1) = {"
Sh
dR
dR
dR
dR
dR
ZU
Ji
ZU
ZU
Sh
Sh
"}
