//MAP CONVERTED BY dmm2tgm.py THIS HEADER COMMENT PREVENTS RECONVERSION, DO NOT REMOVE
"a" = (
/turf/template_noop,
/area/template_noop)
"b" = (
/obj/item/stack/sheet/mineral/titanium,
/turf/template_noop,
/area/template_noop)
"c" = (
/obj/structure/chair/comfy/shuttle{
	dir = 1
	},
/obj/effect/mob_spawn/human/corpse/solgov/infantry,
/obj/effect/turf_decal/siding/thinplating/dark{
	dir = 8
	},
/turf/open/floor/iron,
/area/ruin/unpowered)
"d" = (
/obj/item/card/id/solgov/elite,
/turf/open/floor/carpet/nanoweave/beige,
/area/ruin/unpowered)
"e" = (
/obj/structure/sign/solgov_seal{
	pixel_y = 0;
	pixel_x = -32
	},
/turf/open/floor/plating/wasteland/lit,
/area/overmap_encounter/planetoid/wasteland)
"f" = (
/obj/structure/frame/machine,
/obj/item/stack/cable_coil/random/five,
/turf/open/floor/plating,
/area/ruin/unpowered)
"g" = (
/obj/structure/chair/comfy/shuttle{
	dir = 1
	},
/obj/effect/mob_spawn/human/corpse/solgov/officer{
	head = 0
	},
/obj/effect/decal/cleanable/glass,
/turf/open/floor/carpet/nanoweave/blue,
/area/ruin/unpowered)
"h" = (
/obj/item/shard{
	icon_state = "small"
	},
/obj/effect/decal/cleanable/glass,
/turf/open/floor/plating/wasteland/lit,
/area/overmap_encounter/planetoid/wasteland)
"i" = (
/obj/structure/girder,
/turf/open/floor/plating,
/area/ruin/unpowered)
"j" = (
/obj/effect/decal/cleanable/glass,
/turf/template_noop,
/area/template_noop)
"k" = (
/obj/item/stack/sheet/metal,
/turf/open/floor/plating/wasteland/lit,
/area/overmap_encounter/planetoid/wasteland)
"l" = (
/obj/item/kitchen/knife/letter_opener,
/obj/effect/decal/cleanable/glass,
/turf/open/floor/carpet/nanoweave/blue,
/area/ruin/unpowered)
"m" = (
/obj/structure/grille/broken,
/obj/item/shard{
	icon_state = "small"
	},
/obj/effect/decal/cleanable/glass,
/obj/item/stack/rods,
/turf/open/floor/plating,
/area/ruin/unpowered)
"o" = (
/obj/item/shard{
	icon_state = "medium"
	},
/obj/effect/decal/cleanable/glass,
/turf/open/floor/plating/wasteland/lit,
/area/overmap_encounter/planetoid/wasteland)
"p" = (
/obj/structure/chair/comfy/shuttle{
	dir = 1
	},
/obj/effect/turf_decal/siding/thinplating/dark{
	dir = 4
	},
/obj/effect/mob_spawn/human/corpse/solgov/infantry,
/turf/open/floor/iron,
/area/ruin/unpowered)
"r" = (
/turf/closed/wall/mineral/titanium/nodiagonal,
/area/ruin/unpowered)
"s" = (
/obj/structure/door_assembly/door_assembly_shuttle,
/turf/open/floor/plating/wasteland/lit,
/area/overmap_encounter/planetoid/wasteland)
"t" = (
/obj/structure/frame/computer,
/obj/effect/decal/cleanable/glass,
/obj/item/circuitboard/computer/shuttle/helm,
/obj/item/shard{
	icon_state = "medium"
	},
/obj/item/stack/cable_coil/random/five,
/turf/open/floor/carpet/nanoweave/blue,
/area/ruin/unpowered)
"u" = (
/obj/structure/sign/solgov_seal{
	pixel_y = 0;
	pixel_x = -32
	},
/turf/template_noop,
/area/template_noop)
"v" = (
/obj/machinery/door/airlock/solgov/glass{
	name = "Cockpit"
	},
/turf/open/floor/carpet/nanoweave/blue,
/area/ruin/unpowered)
"w" = (
/obj/item/clothing/suit/armor/vest/solgov,
/turf/open/floor/carpet/nanoweave/beige,
/area/ruin/unpowered)
"y" = (
/obj/effect/decal/cleanable/glass,
/obj/item/stack/rods,
/turf/template_noop,
/area/template_noop)
"z" = (
/obj/effect/decal/cleanable/glass,
/turf/open/floor/plating/wasteland/lit,
/area/overmap_encounter/planetoid/wasteland)
"D" = (
/obj/structure/table/reinforced,
/obj/item/desk_flag/solgov,
/obj/item/pen/fountain/solgov,
/turf/open/floor/carpet/nanoweave/blue,
/area/ruin/unpowered)
"E" = (
/obj/structure/sign/poster/official/solgov_enlist{
	pixel_y = 32
	},
/turf/open/floor/carpet/nanoweave/beige,
/area/ruin/unpowered)
"F" = (
/obj/item/stack/sheet/mineral/titanium,
/turf/open/floor/plating/dust/lit,
/area/overmap_encounter/planetoid/wasteland)
"G" = (
/turf/open/floor/plating/dust/lit,
/area/overmap_encounter/planetoid/wasteland)
"H" = (
/obj/item/clothing/under/solgov,
/obj/structure/closet/wall{
	dir = 1;
	pixel_y = -32
	},
/obj/item/clothing/under/solgov,
/obj/item/clothing/under/solgov,
/obj/item/clothing/under/solgov,
/turf/open/floor/carpet/nanoweave/beige,
/area/ruin/unpowered)
"I" = (
/obj/structure/girder/displaced,
/turf/open/floor/plating,
/area/ruin/unpowered)
"J" = (
/obj/item/stack/rods,
/obj/item/stack/sheet/metal,
/turf/open/floor/plating,
/area/ruin/unpowered)
"K" = (
/turf/closed/wall/mineral/titanium,
/area/ruin/unpowered)
"L" = (
/obj/item/stack/rods,
/turf/open/floor/plating/dust/lit,
/area/overmap_encounter/planetoid/wasteland)
"M" = (
/obj/structure/window/shuttle,
/obj/structure/grille,
/turf/open/floor/plating,
/area/ruin/unpowered)
"N" = (
/obj/effect/decal/cleanable/glass,
/obj/item/shard{
	icon_state = "small"
	},
/obj/item/clothing/head/beret/solgov,
/turf/open/floor/carpet/nanoweave/blue,
/area/ruin/unpowered)
"O" = (
/obj/machinery/door/airlock/titanium{
	name = "SolGov Cruise Vessel"
	},
/obj/effect/turf_decal/siding/thinplating/dark{
	dir = 4
	},
/obj/effect/turf_decal/siding/thinplating/dark{
	dir = 8
	},
/turf/open/floor/iron,
/area/ruin/unpowered)
"P" = (
/obj/structure/chair/comfy/shuttle{
	dir = 1
	},
/obj/effect/turf_decal/siding/thinplating/dark{
	dir = 9
	},
/turf/open/floor/iron,
/area/ruin/unpowered)
"Q" = (
/turf/open/floor/plating/wasteland/lit,
/area/overmap_encounter/planetoid/wasteland)
"R" = (
/obj/item/shard{
	icon_state = "medium"
	},
/turf/template_noop,
/area/template_noop)
"S" = (
/obj/structure/chair/comfy/shuttle{
	dir = 1
	},
/obj/effect/turf_decal/siding/thinplating/dark{
	dir = 5
	},
/turf/open/floor/iron,
/area/ruin/unpowered)
"T" = (
/obj/item/stack/sheet/metal,
/obj/item/shard{
	icon_state = "medium"
	},
/obj/effect/decal/cleanable/glass,
/obj/item/stack/rods,
/obj/item/stack/rods,
/obj/item/stack/sheet/metal,
/turf/open/floor/plating,
/area/ruin/unpowered)
"U" = (
/obj/machinery/power/shuttle/engine/electric{
	dir = 1
	},
/turf/open/floor/plating,
/area/ruin/unpowered)
"V" = (
/obj/item/stack/sheet/metal,
/turf/open/floor/plating/dust/lit,
/area/overmap_encounter/planetoid/wasteland)
"W" = (
/obj/effect/decal/cleanable/glass,
/turf/open/floor/plating/dust/lit,
/area/overmap_encounter/planetoid/wasteland)
"X" = (
/obj/structure/grille/broken,
/obj/item/shard,
/obj/effect/decal/cleanable/glass,
/obj/item/stack/rods,
/obj/item/stack/rods,
/turf/open/floor/plating,
/area/ruin/unpowered)
"Y" = (
/obj/effect/gibspawner/human,
/obj/item/clothing/under/solgov/elite,
/obj/item/clothing/head/helmet/solgov,
/obj/item/gun/energy/laser/terra,
/turf/open/floor/plating,
/area/ruin/unpowered)
"Z" = (
/obj/machinery/power/smes/shuttle{
	dir = 1
	},
/obj/structure/window/reinforced{
	dir = 1
	},
/turf/open/floor/plating,
/area/ruin/unpowered)

(1,1,1) = {"
a
a
y
a
a
a
a
a
a
a
a
a
b
a
a
a
j
a
a
a
a
a
a
a
a
a
a
a
"}
(2,1,1) = {"
R
I
m
i
i
J
i
r
r
r
Q
a
a
a
o
z
Q
s
Q
a
j
Q
z
a
a
b
a
a
"}
(3,1,1) = {"
y
X
T
l
r
Y
S
p
Z
f
G
G
G
F
L
G
V
W
Q
Q
z
k
h
Q
z
Q
Q
a
"}
(4,1,1) = {"
a
M
t
g
v
d
w
H
r
r
G
G
G
G
G
G
G
G
W
G
F
G
G
G
G
G
F
a
"}
(5,1,1) = {"
a
M
D
N
r
E
P
c
Z
U
G
G
G
G
G
G
G
G
G
G
G
G
G
G
Q
Q
a
a
"}
(6,1,1) = {"
a
K
M
r
r
O
r
r
r
r
Q
Q
Q
Q
Q
Q
G
G
G
G
G
Q
Q
Q
a
a
a
a
"}
(7,1,1) = {"
a
u
Q
Q
Q
Q
e
Q
Q
Q
Q
Q
Q
Q
Q
Q
Q
Q
Q
Q
Q
Q
a
a
a
a
a
a
"}
(8,1,1) = {"
a
a
a
a
a
a
a
a
a
a
Q
a
a
a
a
Q
Q
Q
a
a
Q
a
a
a
a
a
a
a
"}
(9,1,1) = {"
a
a
a
a
a
a
a
a
a
a
a
a
a
a
a
a
a
a
a
a
a
a
a
a
a
a
a
a
"}
