//MAP CONVERTED BY dmm2tgm.py THIS HEADER COMMENT PREVENTS RECONVERSION, DO NOT REMOVE
"av" = (
/obj/machinery/suit_storage_unit/solgov,
/turf/open/floor/wood/parquet,
/area/ruin/powered)
"bd" = (
/obj/effect/turf_decal/corner/purple/diagonal,
/obj/item/ammo_casing,
/obj/item/ammo_casing,
/obj/item/ammo_casing,
/obj/item/ammo_casing,
/obj/item/ammo_casing,
/turf/open/floor/iron/white,
/area/ruin/powered)
"bi" = (
/obj/structure/chair/sofa/right{
	dir = 1;
	color = "#4C5B76"
	},
/obj/effect/turf_decal/corner/blue/diagonal_centre,
/turf/open/floor/iron/white/diagonal,
/area/ruin/powered)
"bz" = (
/obj/structure/girder/reinforced,
/turf/open/floor/plating,
/area/ruin/powered)
"bG" = (
/obj/effect/turf_decal/corner/purple/diagonal,
/obj/machinery/light/dim{
	dir = 1
	},
/turf/open/floor/iron/white,
/area/ruin/powered)
"bM" = (
/obj/effect/turf_decal/industrial/warning,
/obj/structure/railing,
/turf/open/floor/iron,
/area/ruin/powered)
"cc" = (
/obj/effect/turf_decal/siding/wood{
	dir = 4
	},
/obj/structure/chair/sofa/left{
	dir = 4;
	color = "#4C5B76"
	},
/obj/machinery/light/dim{
	dir = 8
	},
/turf/open/floor/wood/large,
/area/ruin/powered)
"cr" = (
/obj/machinery/door/airlock/public/glass{
	name = "SolGov Weapon Manufacturing Lab"
	},
/turf/open/floor/iron/dark/smooth_half,
/area/ruin/powered)
"cz" = (
/obj/structure/table/reinforced,
/turf/open/floor/iron/herringbone,
/area/ruin/powered)
"cH" = (
/obj/structure/table/reinforced/titaniumglass,
/turf/open/floor/plating,
/area/ruin/powered)
"cJ" = (
/turf/open/floor/iron/dark/small,
/area/ruin/powered)
"df" = (
/obj/machinery/door/airlock/solgov{
	name = "Weapon Storage"
	},
/turf/open/floor/iron/dark/smooth_half,
/area/ruin/powered)
"dz" = (
/obj/structure/table/reinforced/titaniumglass,
/obj/item/gun/ballistic/automatic/pistol/solgov,
/turf/open/floor/iron/dark/small,
/area/ruin/powered)
"dD" = (
/obj/machinery/porta_turret/syndicate/energy{
	dir = 6
	},
/turf/open/floor/iron/dark/small,
/area/ruin/powered)
"dS" = (
/obj/structure/sign/poster/official/solgov_enlist{
	pixel_y = 32
	},
/obj/structure/fluff/paper/stack,
/obj/effect/turf_decal/corner/blue/diagonal_centre,
/turf/open/floor/iron/white/diagonal,
/area/ruin/powered)
"eh" = (
/obj/structure/fluff/paper/stack{
	dir = 4
	},
/turf/open/floor/iron/herringbone,
/area/ruin/powered)
"ej" = (
/obj/machinery/vending/snack/random,
/obj/effect/turf_decal/corner/blue/diagonal_centre,
/turf/open/floor/iron/white/diagonal,
/area/ruin/powered)
"ey" = (
/obj/structure/filingcabinet,
/obj/machinery/light/dim{
	dir = 4
	},
/turf/open/floor/iron/herringbone,
/area/ruin/powered)
"eV" = (
/obj/machinery/porta_turret/syndicate/energy{
	dir = 10
	},
/turf/open/floor/iron/dark/small,
/area/ruin/powered)
"fq" = (
/obj/item/ammo_box/n762,
/obj/effect/turf_decal/corner/purple/diagonal,
/obj/structure/table/reinforced/titaniumglass,
/turf/open/floor/iron/white,
/area/ruin/powered)
"fJ" = (
/obj/structure/rack,
/turf/open/floor/iron/herringbone,
/area/ruin/powered)
"fO" = (
/obj/structure/fluff/paper/stack{
	dir = 9
	},
/turf/open/floor/carpet/nanoweave/beige,
/area/ruin/powered)
"fP" = (
/obj/structure/fluff/paper/stack{
	dir = 5
	},
/turf/open/floor/iron/herringbone,
/area/ruin/powered)
"gm" = (
/obj/item/storage/backpack/duffelbag/med/surgery,
/obj/structure/table/reinforced/rglass,
/turf/open/floor/iron/white/small,
/area/ruin/powered)
"gw" = (
/obj/structure/fluff/paper/stack{
	dir = 8
	},
/turf/open/floor/carpet/nanoweave/purple,
/area/ruin/powered)
"gx" = (
/obj/effect/decal/cleanable/blood,
/obj/effect/mob_spawn/human/corpse/solgov/infantry,
/turf/open/floor/carpet/nanoweave/purple,
/area/ruin/powered)
"gy" = (
/obj/structure/table/wood/poker,
/obj/item/toy/cards/deck{
	pixel_y = 5
	},
/obj/item/reagent_containers/food/drinks/beer{
	pixel_y = 13;
	pixel_x = -9
	},
/turf/open/floor/wood/large,
/area/ruin/powered)
"gz" = (
/obj/machinery/door/window/southright{
	name = "Reception Desk"
	},
/obj/structure/table/reinforced/rglass,
/obj/item/folder,
/turf/open/floor/iron/dark/smooth_half,
/area/ruin/powered)
"gX" = (
/obj/structure/barricade/sandbags,
/obj/effect/turf_decal/industrial/warning{
	dir = 9
	},
/obj/structure/railing{
	dir = 1
	},
/turf/open/floor/iron,
/area/ruin/powered)
"hl" = (
/obj/machinery/light/floor,
/turf/open/floor/iron/tech/grid,
/area/ruin/powered)
"hw" = (
/obj/effect/turf_decal/siding/wood/corner{
	dir = 4
	},
/obj/structure/table/wood/reinforced,
/obj/item/desk_flag/solgov,
/turf/open/floor/wood/large,
/area/ruin/powered)
"hz" = (
/obj/machinery/light/dim,
/turf/open/floor/iron/herringbone,
/area/ruin/powered)
"hV" = (
/obj/effect/turf_decal/siding/wood{
	dir = 1
	},
/turf/open/floor/wood/large,
/area/ruin/powered)
"ih" = (
/obj/item/stack/sheet/mineral/uranium/five,
/obj/structure/sign/poster/official/random{
	pixel_x = -32
	},
/obj/structure/table/reinforced,
/obj/machinery/light/dim{
	dir = 8
	},
/turf/open/floor/carpet/nanoweave/beige,
/area/ruin/powered)
"ii" = (
/obj/item/folder,
/obj/machinery/door/window/southleft{
	name = "Reception Desk"
	},
/obj/item/clothing/head/beret/solgov/plain,
/obj/structure/table/reinforced/rglass,
/turf/open/floor/iron/dark/smooth_half,
/area/ruin/powered)
"ij" = (
/obj/machinery/computer/security/wooden_tv,
/turf/open/floor/carpet/nanoweave,
/area/ruin/powered)
"iy" = (
/obj/effect/turf_decal/corner/blue/diagonal_centre,
/turf/open/floor/iron/white/diagonal,
/area/ruin/powered)
"iB" = (
/obj/effect/spawner/structure/window,
/turf/open/floor/plating,
/area/ruin/powered)
"iI" = (
/obj/structure/filingcabinet,
/obj/machinery/light/dim{
	dir = 8
	},
/turf/open/floor/iron/herringbone,
/area/ruin/powered)
"iM" = (
/obj/effect/mob_spawn/human/corpse/solgov/officer,
/obj/effect/decal/cleanable/blood,
/turf/open/floor/iron/herringbone,
/area/ruin/powered)
"jn" = (
/obj/effect/turf_decal/industrial/warning{
	dir = 1
	},
/turf/open/floor/iron,
/area/ruin/powered)
"jo" = (
/obj/structure/railing{
	dir = 1
	},
/obj/effect/turf_decal/industrial/warning{
	dir = 1
	},
/turf/open/floor/iron,
/area/ruin/powered)
"jD" = (
/obj/machinery/door/airlock/solgov/glass{
	name = "Reception"
	},
/turf/open/floor/iron/dark/smooth_half,
/area/ruin/powered)
"kb" = (
/turf/open/floor/plating{
	icon_state = "panelscorched"
	},
/area/ruin/powered)
"kj" = (
/obj/structure/table/reinforced/titaniumglass,
/obj/item/ammo_box/magazine/co9mm,
/obj/machinery/light/dim{
	dir = 8
	},
/turf/open/floor/iron/dark/small,
/area/ruin/powered)
"kR" = (
/obj/item/ammo_box/magazine/pistol556mm,
/obj/structure/table/reinforced/titaniumglass,
/turf/open/floor/iron/dark/small,
/area/ruin/powered)
"kV" = (
/obj/structure/chair/office/light{
	dir = 8
	},
/turf/open/floor/iron/white/small,
/area/ruin/powered)
"lw" = (
/obj/structure/sign/solgov_seal{
	pixel_y = 32
	},
/turf/open/floor/wood/parquet,
/area/ruin/powered)
"lW" = (
/obj/structure/table/glass,
/obj/item/paper,
/obj/effect/turf_decal/corner/blue/diagonal_centre,
/turf/open/floor/iron/white/diagonal,
/area/ruin/powered)
"lX" = (
/obj/machinery/door/airlock/medical/glass{
	name = "Medical Post"
	},
/turf/open/floor/iron/dark/smooth_half,
/area/ruin/powered)
"nn" = (
/obj/item/ammo_box/magazine/co9mm,
/obj/structure/table/reinforced/titaniumglass,
/turf/open/floor/iron/dark/small,
/area/ruin/powered)
"oe" = (
/obj/item/modular_computer/laptop/preset,
/obj/structure/table/wood/reinforced,
/turf/open/floor/wood/parquet,
/area/ruin/powered)
"ov" = (
/obj/structure/table/wood/reinforced,
/obj/item/paper_bin,
/obj/item/pen/fountain/solgov,
/turf/open/floor/wood/parquet,
/area/ruin/powered)
"oN" = (
/obj/effect/spawner/structure/window/reinforced,
/turf/open/floor/plating,
/area/ruin/powered)
"oZ" = (
/obj/machinery/door/airlock/security{
	name = "Lab Access"
	},
/turf/open/floor/iron/dark/smooth_half,
/area/ruin/powered)
"pf" = (
/obj/structure/rack,
/obj/structure/sign/solgov_flag/right{
	pixel_y = 32
	},
/obj/machinery/light/dim{
	dir = 1
	},
/turf/open/floor/iron/herringbone,
/area/ruin/powered)
"pL" = (
/obj/machinery/light/dim,
/turf/open/floor/iron,
/area/ruin/powered)
"qg" = (
/turf/open/floor/wood/parquet,
/area/ruin/powered)
"qn" = (
/obj/structure/barricade/sandbags,
/obj/effect/turf_decal/industrial/warning{
	dir = 8
	},
/turf/open/floor/iron,
/area/ruin/powered)
"qG" = (
/obj/effect/decal/cleanable/blood,
/obj/effect/mob_spawn/human/corpse/solgov/infantry,
/turf/open/floor/iron,
/area/ruin/powered)
"rw" = (
/obj/structure/chair/comfy{
	dir = 1;
	color = "#292B2D"
	},
/turf/open/floor/wood/parquet,
/area/ruin/powered)
"sm" = (
/obj/effect/turf_decal/siding/wood{
	dir = 4
	},
/obj/structure/chair/sofa{
	dir = 4;
	color = "#4C5B76"
	},
/turf/open/floor/wood/large,
/area/ruin/powered)
"sv" = (
/obj/structure/rack,
/obj/structure/sign/solgov_flag{
	pixel_y = 32
	},
/obj/machinery/light/dim{
	dir = 1
	},
/turf/open/floor/iron/herringbone,
/area/ruin/powered)
"sN" = (
/obj/effect/turf_decal/industrial/warning{
	dir = 1
	},
/obj/structure/railing{
	dir = 1
	},
/turf/open/floor/iron,
/area/ruin/powered)
"sQ" = (
/obj/machinery/light/floor,
/turf/open/floor/iron,
/area/ruin/powered)
"to" = (
/turf/open/floor/plating{
	icon_state = "platingdmg2";
	initial_gas_mix = "o2=22;n2=82;TEMP=503.15"
	},
/area/ruin/powered)
"tp" = (
/obj/item/ammo_casing,
/obj/item/ammo_casing,
/obj/item/ammo_casing,
/obj/structure/fluff/paper/stack,
/turf/open/floor/carpet/nanoweave/purple,
/area/ruin/powered)
"tr" = (
/obj/structure/chair/office,
/turf/open/floor/iron/herringbone,
/area/ruin/powered)
"tD" = (
/turf/template_noop,
/area/template_noop)
"uk" = (
/obj/structure/fluff/paper/stack{
	dir = 1
	},
/turf/open/floor/wood/parquet,
/area/ruin/powered)
"uB" = (
/obj/effect/turf_decal/corner/purple/diagonal,
/obj/item/ammo_casing,
/obj/item/ammo_casing,
/turf/open/floor/iron/white,
/area/ruin/powered)
"uO" = (
/obj/effect/turf_decal/siding/wood/corner{
	dir = 8
	},
/obj/structure/table/wood/reinforced,
/obj/machinery/microwave{
	pixel_y = 6
	},
/turf/open/floor/wood/large,
/area/ruin/powered)
"uT" = (
/obj/effect/turf_decal/siding/wood{
	dir = 4
	},
/obj/structure/chair/sofa/right{
	dir = 4;
	color = "#4C5B76"
	},
/obj/machinery/light/dim{
	dir = 8
	},
/turf/open/floor/wood/large,
/area/ruin/powered)
"uV" = (
/obj/structure/chair/office{
	dir = 8
	},
/turf/open/floor/carpet/nanoweave/beige,
/area/ruin/powered)
"uW" = (
/obj/structure/window/reinforced,
/obj/item/desk_flag/solgov,
/obj/item/kitchen/knife/letter_opener{
	pixel_x = -11
	},
/obj/structure/table/reinforced/rglass,
/turf/open/floor/iron/dark/smooth_half,
/area/ruin/powered)
"vY" = (
/obj/effect/turf_decal/corner/purple/diagonal,
/turf/open/floor/iron/white,
/area/ruin/powered)
"wf" = (
/obj/item/paper_bin,
/obj/structure/window/reinforced,
/obj/item/pen/solgov,
/obj/structure/table/reinforced/rglass,
/turf/open/floor/iron/dark/smooth_half,
/area/ruin/powered)
"wj" = (
/obj/structure/chair/wood,
/obj/machinery/light/dim{
	dir = 4
	},
/turf/open/floor/wood/large,
/area/ruin/powered)
"wp" = (
/obj/structure/fluff/paper/stack{
	dir = 9
	},
/turf/open/floor/carpet/nanoweave/purple,
/area/ruin/powered)
"ww" = (
/obj/item/flashlight/lamp,
/obj/structure/window/reinforced,
/obj/structure/table/reinforced/rglass,
/turf/open/floor/iron/dark/smooth_half,
/area/ruin/powered)
"wM" = (
/obj/machinery/door/airlock/public/glass,
/turf/open/floor/iron/dark/smooth_half{
	dir = 1
	},
/area/ruin/powered)
"xe" = (
/obj/machinery/light/dim,
/turf/open/floor/iron/dark/small,
/area/ruin/powered)
"xo" = (
/obj/structure/table/reinforced,
/obj/item/stack/sheet/metal/ten,
/turf/open/floor/carpet/nanoweave/beige,
/area/ruin/powered)
"xz" = (
/obj/effect/turf_decal/corner/purple/diagonal,
/obj/item/ammo_casing,
/obj/structure/fluff/paper/stack{
	dir = 5
	},
/turf/open/floor/iron/white,
/area/ruin/powered)
"xA" = (
/obj/effect/turf_decal/siding/wood/corner{
	dir = 1
	},
/turf/open/floor/wood/large,
/area/ruin/powered)
"yd" = (
/obj/structure/sign/poster/official/random{
	pixel_y = 32
	},
/obj/effect/turf_decal/corner/purple/diagonal,
/turf/open/floor/iron/white,
/area/ruin/powered)
"yg" = (
/obj/structure/sign/poster/official/random{
	pixel_y = -32
	},
/obj/item/storage/firstaid/medical,
/obj/item/storage/firstaid/fire{
	pixel_y = 6
	},
/obj/structure/table/reinforced/rglass,
/obj/machinery/light/dim,
/turf/open/floor/iron/white/small,
/area/ruin/powered)
"yv" = (
/turf/open/floor/engine/hull/reinforced/interior,
/area/ruin/powered)
"yY" = (
/obj/structure/table/reinforced/titaniumglass,
/turf/open/floor/iron/dark/small,
/area/ruin/powered)
"zi" = (
/obj/effect/decal/cleanable/blood/tracks,
/turf/open/floor/iron/tech/grid,
/area/ruin/powered)
"zx" = (
/turf/open/floor/iron/white/small,
/area/ruin/powered)
"AG" = (
/obj/structure/chair/office,
/turf/open/floor/wood/parquet,
/area/ruin/powered)
"Bv" = (
/obj/effect/turf_decal/corner/purple/diagonal,
/obj/machinery/light/dim,
/turf/open/floor/iron/white,
/area/ruin/powered)
"BD" = (
/obj/effect/turf_decal/siding/wood,
/obj/structure/table/wood/reinforced,
/turf/open/floor/wood/large,
/area/ruin/powered)
"Cg" = (
/obj/item/kirbyplants,
/turf/open/floor/iron/herringbone,
/area/ruin/powered)
"Cw" = (
/obj/effect/turf_decal/siding/wood{
	dir = 8
	},
/turf/open/floor/wood/large,
/area/ruin/powered)
"CK" = (
/obj/effect/turf_decal/corner/purple/diagonal,
/obj/structure/table/reinforced/titaniumglass,
/turf/open/floor/iron/white,
/area/ruin/powered)
"CN" = (
/obj/item/weaponcrafting/gunkit/capgun_ugrade_kit,
/obj/structure/table/reinforced/titaniumglass,
/turf/open/floor/iron/dark/small,
/area/ruin/powered)
"Dx" = (
/obj/effect/turf_decal/siding/wood,
/obj/structure/table/wood/reinforced,
/obj/item/storage/box/donkpockets{
	pixel_y = 7
	},
/turf/open/floor/wood/large,
/area/ruin/powered)
"DW" = (
/turf/closed/wall/r_wall,
/area/ruin/powered)
"Ea" = (
/obj/structure/table/reinforced/titaniumglass,
/obj/item/ammo_box/magazine/rifle47x33mm,
/obj/machinery/light/dim{
	dir = 4
	},
/turf/open/floor/iron/dark/small,
/area/ruin/powered)
"EW" = (
/obj/effect/turf_decal/corner/purple/diagonal,
/obj/structure/table/reinforced/titaniumglass,
/obj/item/ammo_box/c45,
/turf/open/floor/iron/white,
/area/ruin/powered)
"Fb" = (
/obj/effect/turf_decal/corner/purple/diagonal,
/obj/structure/sign/poster/official/random{
	pixel_y = 32
	},
/turf/open/floor/iron/white,
/area/ruin/powered)
"FC" = (
/obj/structure/table/reinforced,
/turf/open/floor/carpet/nanoweave/beige,
/area/ruin/powered)
"Gc" = (
/obj/item/stack/cable_coil/cut,
/obj/structure/table/reinforced,
/turf/open/floor/carpet/nanoweave/beige,
/area/ruin/powered)
"Ge" = (
/obj/machinery/autolathe/hacked,
/turf/open/floor/carpet/nanoweave/beige,
/area/ruin/powered)
"Gj" = (
/obj/structure/table/reinforced,
/obj/item/storage/toolbox/mechanical,
/turf/open/floor/carpet/nanoweave/beige,
/area/ruin/powered)
"Gn" = (
/obj/machinery/porta_turret/syndicate/energy{
	dir = 9
	},
/turf/open/floor/iron/dark/small,
/area/ruin/powered)
"Gw" = (
/obj/structure/table/reinforced/titaniumglass,
/obj/item/gun/ballistic/shotgun/lethal,
/obj/machinery/light/dim{
	dir = 4
	},
/turf/open/floor/iron/dark/small,
/area/ruin/powered)
"GP" = (
/obj/item/desk_flag/solgov,
/obj/structure/window/reinforced,
/obj/structure/window/reinforced{
	dir = 8;
	pixel_x = -4
	},
/obj/item/kitchen/knife/letter_opener{
	pixel_x = 10
	},
/obj/structure/table/reinforced/rglass,
/turf/open/floor/iron/dark/smooth_half,
/area/ruin/powered)
"GR" = (
/obj/structure/chair/office{
	dir = 1
	},
/turf/open/floor/carpet/nanoweave/beige,
/area/ruin/powered)
"GT" = (
/obj/structure/table/reinforced/titaniumglass,
/obj/item/gun/ballistic/automatic/solar,
/turf/open/floor/iron/dark/small,
/area/ruin/powered)
"GZ" = (
/obj/structure/chair/comfy{
	color = "#4C5B76";
	dir = 4
	},
/obj/machinery/light/dim{
	dir = 8
	},
/obj/effect/turf_decal/corner/blue/diagonal_centre,
/turf/open/floor/iron/white/diagonal,
/area/ruin/powered)
"HL" = (
/obj/machinery/door/airlock/solgov/glass{
	name = "Manufacturing Workstations"
	},
/turf/open/floor/iron/dark/smooth_half{
	dir = 1
	},
/area/ruin/powered)
"HM" = (
/obj/effect/decal/cleanable/blood,
/turf/open/floor/iron/tech/grid,
/area/ruin/powered)
"HR" = (
/obj/effect/decal/cleanable/blood/tracks{
	dir = 9
	},
/turf/open/floor/iron/herringbone,
/area/ruin/powered)
"HW" = (
/obj/machinery/vending/cola/random,
/obj/effect/turf_decal/corner/blue/diagonal_centre,
/turf/open/floor/iron/white/diagonal,
/area/ruin/powered)
"Ie" = (
/obj/machinery/door/airlock/solgov/glass{
	name = "Testing Lab"
	},
/turf/open/floor/iron/dark/smooth_half,
/area/ruin/powered)
"IB" = (
/obj/structure/table/glass,
/obj/item/desk_flag/solgov,
/obj/effect/turf_decal/corner/blue/diagonal_centre,
/turf/open/floor/iron/white/diagonal,
/area/ruin/powered)
"Je" = (
/obj/structure/fluff/paper/stack{
	dir = 1
	},
/turf/open/floor/iron/herringbone,
/area/ruin/powered)
"Jo" = (
/obj/effect/turf_decal/siding/wood,
/obj/structure/reagent_dispensers/water_cooler,
/turf/open/floor/wood/large,
/area/ruin/powered)
"Jy" = (
/obj/effect/decal/cleanable/blood/gibs/core,
/obj/effect/decal/cleanable/blood,
/turf/open/floor/iron/tech/grid,
/area/ruin/powered)
"JR" = (
/obj/machinery/door/airlock/security{
	name = "Lab Access"
	},
/obj/effect/decal/cleanable/blood/tracks,
/turf/open/floor/iron/dark/smooth_half,
/area/ruin/powered)
"Kd" = (
/obj/structure/table/wood/reinforced,
/obj/item/documents/syndicate/blue,
/turf/open/floor/wood/parquet,
/area/ruin/powered)
"Kk" = (
/turf/open/floor/plating,
/area/ruin/powered)
"Kn" = (
/obj/effect/turf_decal/corner/purple/diagonal,
/obj/structure/displaycase/noalert{
	start_showpiece_type = /obj/item/gun/energy/laser/captain/brazil
	},
/turf/open/floor/iron/white,
/area/ruin/powered)
"Kz" = (
/turf/open/floor/carpet/nanoweave/beige,
/area/ruin/powered)
"KH" = (
/obj/structure/table/reinforced/titaniumglass,
/obj/item/ammo_box/magazine/rifle47x33mm,
/turf/open/floor/iron/dark/small,
/area/ruin/powered)
"KW" = (
/obj/machinery/door/airlock/solgov{
	name = "Ammunition Storage"
	},
/turf/open/floor/iron/dark/smooth_half,
/area/ruin/powered)
"Lo" = (
/obj/structure/table/wood/reinforced,
/obj/item/desk_flag/solgov,
/turf/open/floor/wood/parquet,
/area/ruin/powered)
"LC" = (
/obj/machinery/door/airlock/solgov/glass{
	name = "Employee Lounge"
	},
/obj/effect/turf_decal/siding/wood{
	dir = 1
	},
/turf/open/floor/iron/dark/smooth_half,
/area/ruin/powered)
"LN" = (
/obj/item/ammo_casing,
/obj/item/ammo_casing,
/turf/open/floor/carpet/nanoweave/purple,
/area/ruin/powered)
"Ma" = (
/obj/structure/sign/poster/official/random{
	pixel_x = -32
	},
/obj/structure/table/reinforced,
/obj/machinery/light/dim{
	dir = 8
	},
/turf/open/floor/carpet/nanoweave/beige,
/area/ruin/powered)
"Mt" = (
/obj/machinery/computer/crew{
	dir = 1
	},
/turf/open/floor/iron/white/small,
/area/ruin/powered)
"Mx" = (
/obj/machinery/porta_turret/syndicate/energy{
	dir = 5
	},
/turf/open/floor/iron/dark/small,
/area/ruin/powered)
"Nl" = (
/obj/effect/turf_decal/corner/purple/diagonal,
/obj/effect/decal/cleanable/blood/splatter,
/obj/item/ammo_casing,
/obj/item/ammo_casing,
/obj/item/ammo_casing,
/obj/item/ammo_casing,
/obj/item/ammo_casing,
/obj/item/gun/ballistic/automatic/pistol/solgov,
/turf/open/floor/iron/white,
/area/ruin/powered)
"Nm" = (
/obj/structure/sign/poster/official/random{
	pixel_y = 32
	},
/turf/open/floor/iron/herringbone,
/area/ruin/powered)
"Oq" = (
/obj/structure/chair/wood{
	dir = 1
	},
/obj/machinery/light/dim{
	dir = 4
	},
/turf/open/floor/wood/large,
/area/ruin/powered)
"OB" = (
/obj/machinery/porta_turret/syndicate/energy{
	dir = 9
	},
/turf/open/floor/engine/hull/reinforced/interior,
/area/ruin/powered)
"Qg" = (
/obj/effect/turf_decal/industrial/warning{
	dir = 10
	},
/obj/structure/railing,
/obj/structure/barricade/sandbags,
/turf/open/floor/iron,
/area/ruin/powered)
"Ra" = (
/obj/structure/table/glass,
/obj/item/paper,
/obj/item/paper{
	pixel_y = 8;
	pixel_x = 5
	},
/obj/effect/turf_decal/corner/blue/diagonal_centre,
/turf/open/floor/iron/white/diagonal,
/area/ruin/powered)
"Rt" = (
/turf/open/floor/iron,
/area/ruin/powered)
"Rw" = (
/obj/effect/turf_decal/corner/purple/diagonal,
/obj/structure/table/reinforced/titaniumglass,
/obj/item/ammo_box/c9mm/rubbershot,
/turf/open/floor/iron/white,
/area/ruin/powered)
"RM" = (
/obj/structure/table/reinforced,
/obj/structure/fluff{
	icon = 'voidcrew/icons/obj/guns/energy.dmi';
	icon_state = "terralaser";
	name = "TerraGov laser rifle showcase";
	desc = "A old laser rifle that was used by SolGov. Has a self-recharging cell but only 6 shots before needing to recharge. This should be in a musuem instead. Which it is this time! And fully non-functional."
	},
/obj/structure/sign/warning/securearea{
	pixel_y = 32
	},
/turf/open/floor/iron/herringbone,
/area/ruin/powered)
"RR" = (
/obj/item/kirbyplants,
/obj/effect/turf_decal/corner/blue/diagonal_centre,
/turf/open/floor/iron/white/diagonal,
/area/ruin/powered)
"RS" = (
/obj/structure/fluff/paper/stack{
	dir = 4
	},
/turf/open/floor/wood/parquet,
/area/ruin/powered)
"Sj" = (
/obj/machinery/light/dim{
	dir = 8
	},
/turf/open/floor/engine/hull/reinforced/interior,
/area/ruin/powered)
"Tf" = (
/obj/item/desk_flag/solgov,
/obj/structure/table/reinforced/rglass,
/turf/open/floor/iron/white/small,
/area/ruin/powered)
"TJ" = (
/obj/structure/chair/sofa/left{
	dir = 1;
	color = "#4C5B76"
	},
/obj/effect/turf_decal/corner/blue/diagonal_centre,
/turf/open/floor/iron/white/diagonal,
/area/ruin/powered)
"TU" = (
/obj/effect/turf_decal/corner/purple/diagonal,
/obj/machinery/light/dim{
	dir = 8
	},
/turf/open/floor/iron/white,
/area/ruin/powered)
"Us" = (
/obj/item/ammo_casing,
/obj/item/ammo_casing,
/obj/item/ammo_casing,
/turf/open/floor/carpet/nanoweave/purple,
/area/ruin/powered)
"UC" = (
/obj/structure/girder,
/turf/open/floor/plating{
	icon_state = "panelscorched"
	},
/area/ruin/powered)
"Ve" = (
/obj/item/kirbyplants,
/turf/open/floor/wood/large,
/area/ruin/powered)
"Vf" = (
/obj/machinery/porta_turret/syndicate/energy,
/turf/open/floor/iron/dark/small,
/area/ruin/powered)
"Vw" = (
/obj/structure/fluff/paper/stack{
	dir = 8
	},
/obj/effect/turf_decal/corner/blue/diagonal_centre,
/turf/open/floor/iron/white/diagonal,
/area/ruin/powered)
"Vx" = (
/obj/structure/fluff/paper/stack{
	dir = 4
	},
/turf/open/floor/carpet/nanoweave/beige,
/area/ruin/powered)
"VM" = (
/obj/structure/chair/comfy{
	color = "#4C5B76";
	dir = 8
	},
/obj/machinery/light/dim{
	dir = 4
	},
/obj/effect/turf_decal/corner/blue/diagonal_centre,
/turf/open/floor/iron/white/diagonal,
/area/ruin/powered)
"VP" = (
/obj/structure/fluff/paper/stack{
	dir = 1
	},
/turf/open/floor/iron/dark/small,
/area/ruin/powered)
"We" = (
/obj/structure/fluff/paper/stack{
	dir = 5
	},
/turf/open/floor/carpet/nanoweave/beige,
/area/ruin/powered)
"Wn" = (
/obj/effect/turf_decal/industrial/warning,
/turf/open/floor/iron,
/area/ruin/powered)
"Wt" = (
/obj/structure/table/reinforced,
/obj/item/reagent_containers/food/drinks/trophy/gold_cup{
	name = "Xenomorph Erradication trophy";
	desc = "Seems like the old days when this was actually true."
	},
/turf/open/floor/iron/herringbone,
/area/ruin/powered)
"WB" = (
/obj/item/weldingtool/hugetank,
/obj/structure/table/reinforced,
/turf/open/floor/carpet/nanoweave/beige,
/area/ruin/powered)
"WR" = (
/obj/effect/decal/cleanable/blood/splatter,
/obj/effect/decal/cleanable/blood/gibs/core,
/obj/effect/decal/cleanable/blood/tracks,
/obj/effect/decal/cleanable/blood/innards,
/turf/open/floor/iron/herringbone,
/area/ruin/powered)
"Xl" = (
/obj/structure/table/wood/reinforced,
/obj/machinery/photocopier/faxmachine,
/obj/structure/sign/poster/official/solgov_enlist{
	pixel_y = 32
	},
/obj/machinery/light/dim{
	dir = 1
	},
/turf/open/floor/wood/parquet,
/area/ruin/powered)
"XA" = (
/obj/machinery/door/airlock/solgov/glass{
	name = "Manager's Office"
	},
/turf/open/floor/iron/dark/smooth_half,
/area/ruin/powered)
"XT" = (
/obj/machinery/stasis{
	dir = 4
	},
/turf/open/floor/iron/white/small,
/area/ruin/powered)
"Yj" = (
/obj/effect/turf_decal/siding/wood/corner,
/obj/structure/table/wood/reinforced,
/obj/item/flashlight/lamp/green,
/turf/open/floor/wood/large,
/area/ruin/powered)
"Yl" = (
/obj/structure/fluff/paper/stack{
	dir = 5
	},
/turf/open/floor/iron/dark/small,
/area/ruin/powered)
"Yv" = (
/obj/structure/fluff/paper/stack{
	dir = 6
	},
/turf/open/floor/carpet/nanoweave/beige,
/area/ruin/powered)
"YW" = (
/obj/effect/turf_decal/corner/purple/diagonal,
/obj/item/ammo_casing,
/obj/structure/fluff/paper/stack,
/turf/open/floor/iron/white,
/area/ruin/powered)
"YX" = (
/turf/open/floor/iron/tech/grid,
/area/ruin/powered)
"Zd" = (
/obj/effect/decal/cleanable/blood/tracks,
/turf/open/floor/iron,
/area/ruin/powered)
"Zi" = (
/turf/open/floor/iron/herringbone,
/area/ruin/powered)
"Zs" = (
/obj/machinery/light/dim{
	dir = 4
	},
/turf/open/floor/engine/hull/reinforced/interior,
/area/ruin/powered)
"Zu" = (
/obj/structure/table/reinforced/titaniumglass,
/obj/item/gun/ballistic/automatic/pistol/commander/no_mag,
/obj/machinery/light/dim{
	dir = 8
	},
/turf/open/floor/iron/dark/small,
/area/ruin/powered)
"ZX" = (
/turf/open/floor/carpet/nanoweave,
/area/ruin/powered)

(1,1,1) = {"
tD
DW
DW
DW
DW
DW
DW
DW
DW
DW
DW
DW
DW
DW
DW
DW
DW
tD
tD
tD
tD
tD
tD
tD
tD
"}
(2,1,1) = {"
DW
DW
DW
DW
DW
DW
DW
DW
DW
DW
DW
DW
DW
DW
DW
DW
DW
DW
tD
tD
tD
tD
tD
tD
tD
"}
(3,1,1) = {"
DW
DW
DW
lw
Lo
qg
oN
FC
Ma
WB
Gc
ih
xo
oN
gm
XT
DW
DW
DW
tD
tD
tD
tD
tD
tD
"}
(4,1,1) = {"
DW
DW
Kd
AG
oe
rw
oN
FC
uV
We
Gj
GR
Vx
oN
zx
zx
Tf
DW
DW
tD
tD
tD
tD
tD
tD
"}
(5,1,1) = {"
DW
DW
Xl
RS
ov
qg
oN
Ge
Kz
Yv
Ge
fO
Kz
oN
zx
kV
yg
DW
DW
tD
tD
tD
tD
tD
tD
"}
(6,1,1) = {"
DW
DW
av
uk
qg
qg
XA
Yv
Kz
Kz
Kz
Kz
Kz
lX
zx
zx
Mt
DW
DW
tD
tD
tD
tD
tD
tD
"}
(7,1,1) = {"
DW
DW
DW
DW
DW
DW
DW
DW
HL
HL
DW
DW
DW
DW
DW
DW
DW
DW
DW
DW
DW
tD
tD
tD
tD
"}
(8,1,1) = {"
DW
DW
vY
TU
vY
TU
vY
DW
Rt
Rt
DW
yv
Sj
yv
Sj
yv
DW
cz
iI
Cg
DW
DW
DW
DW
DW
"}
(9,1,1) = {"
DW
DW
Kn
fq
EW
Rw
vY
oN
Rt
pL
DW
iB
iB
iB
iB
iB
DW
Nm
Zi
Zi
jD
iy
GZ
RR
DW
"}
(10,1,1) = {"
DW
DW
yd
gw
LN
wp
vY
Ie
qG
Zd
JR
zi
Jy
hl
HM
YX
oZ
Zi
Zi
hz
DW
dS
lW
TJ
oN
"}
(11,1,1) = {"
DW
DW
vY
gx
tp
Us
xz
oN
Rt
Rt
DW
iB
iB
iB
iB
iB
DW
RM
Zi
Zi
wf
iy
IB
bi
oN
"}
(12,1,1) = {"
DW
DW
vY
uB
Nl
bd
YW
oN
Rt
Rt
DW
yv
Zs
OB
Zs
yv
DW
fJ
eh
tr
ii
iy
iy
iy
cr
"}
(13,1,1) = {"
DW
DW
vY
gX
qn
Qg
vY
oN
Rt
Rt
DW
DW
DW
DW
DW
DW
DW
sv
Zi
fP
uW
iy
iy
ej
oN
"}
(14,1,1) = {"
DW
DW
vY
sN
Rt
bM
vY
oN
Rt
pL
DW
Yj
cc
sm
uT
hw
DW
pf
HR
WR
GP
iy
iy
HW
oN
"}
(15,1,1) = {"
DW
DW
vY
jo
sQ
bM
vY
oN
Rt
Rt
DW
Jo
ZX
ZX
ZX
hV
iB
fJ
iM
tr
gz
iy
iy
Vw
cr
"}
(16,1,1) = {"
DW
DW
vY
sN
Rt
bM
vY
oN
Rt
Rt
DW
BD
ZX
ZX
ZX
hV
iB
Wt
Zi
Je
ww
iy
IB
TJ
oN
"}
(17,1,1) = {"
DW
DW
bG
sN
Kk
Wn
Bv
DW
Rt
Rt
DW
Dx
ZX
ij
ZX
hV
LC
Zi
Zi
hz
DW
iy
Ra
bi
oN
"}
(18,1,1) = {"
DW
DW
Fb
jn
kb
Kk
vY
DW
Rt
Rt
DW
uO
Cw
Cw
Cw
xA
DW
Nm
Zi
Zi
jD
iy
VM
RR
DW
"}
(19,1,1) = {"
DW
DW
vY
kb
to
kb
kb
DW
Rt
pL
DW
Ve
wj
gy
Oq
Ve
DW
cz
ey
Cg
DW
DW
DW
DW
DW
"}
(20,1,1) = {"
DW
DW
cH
bz
UC
bz
CK
DW
Rt
Rt
DW
DW
DW
DW
DW
DW
DW
DW
DW
DW
DW
tD
tD
tD
tD
"}
(21,1,1) = {"
DW
DW
DW
DW
DW
DW
DW
DW
wM
wM
DW
dD
dz
Zu
CN
Mx
DW
DW
tD
tD
tD
tD
tD
tD
tD
"}
(22,1,1) = {"
DW
DW
Vf
kR
kj
KH
cJ
DW
VP
cJ
DW
cJ
cJ
cJ
cJ
GT
DW
DW
tD
tD
tD
tD
tD
tD
tD
"}
(23,1,1) = {"
DW
DW
cJ
cJ
cJ
cJ
cJ
KW
cJ
Yl
df
cJ
cJ
cJ
cJ
yY
DW
DW
tD
tD
tD
tD
tD
tD
tD
"}
(24,1,1) = {"
DW
DW
Vf
nn
Ea
kR
cJ
DW
cJ
xe
DW
eV
yY
Gw
dz
Gn
DW
DW
tD
tD
tD
tD
tD
tD
tD
"}
(25,1,1) = {"
DW
DW
DW
DW
DW
DW
DW
DW
DW
DW
DW
DW
DW
DW
DW
DW
DW
DW
tD
tD
tD
tD
tD
tD
tD
"}
(26,1,1) = {"
tD
DW
DW
DW
DW
DW
DW
DW
DW
DW
DW
DW
DW
DW
DW
DW
DW
tD
tD
tD
tD
tD
tD
tD
tD
"}
