"a" = (/turf/template_noop,/area/template_noop)
"b" = (/obj/effect/decal/cleanable/blood/old,/obj/effect/decal/cleanable/dirt,/turf/open/floor/plating,/area/ruin/unpowered)
"c" = (/obj/machinery/hydroponics/soil,/turf/open/floor/plating/rust,/area/ruin/unpowered)
"d" = (/obj/structure/barricade/sandbags,/turf/open/floor/plating/wasteland/lit,/area/overmap_encounter/planetoid/wasteland)
"e" = (/obj/structure/table,/obj/item/ammo_box/aac_300blk_stripper,/obj/item/ammo_box/aac_300blk_stripper,/turf/open/floor/plating/rust,/area/ruin/unpowered)
"f" = (/mob/living/simple_animal/hostile/asteroid/whitesands/ranged/hunter{faction = list("adobe")},/turf/open/floor/plating/rust,/area/ruin/unpowered)
"g" = (/turf/closed/wall,/area/whitesands/surface/outdoors)
"h" = (/obj/structure/table,/obj/item/gun/ballistic/rifle/boltaction/polymer,/turf/open/floor/plating/rust,/area/ruin/unpowered)
"i" = (/obj/item/stack/sheet/mineral/gold/five,/obj/structure/table,/turf/open/floor/plating/rust,/area/ruin/unpowered)
"j" = (/obj/structure/bonfire/prelit,/obj/effect/decal/cleanable/ash,/turf/open/floor/plating/wasteland/lit,/area/overmap_encounter/planetoid/wasteland)
"k" = (/obj/machinery/hydroponics/soil,/turf/open/floor/plating,/area/ruin/unpowered)
"m" = (/obj/structure/reagent_dispensers/watertank,/turf/open/floor/plating/rust,/area/ruin/unpowered)
"n" = (/obj/structure/table,/obj/item/gun/ballistic/automatic/aks74u,/obj/item/ammo_box/magazine/aks74u,/obj/effect/decal/cleanable/dirt,/turf/open/floor/plating/rust,/area/ruin/unpowered)
"o" = (/obj/effect/decal/cleanable/dirt,/turf/open/floor/plating/rust,/area/ruin/unpowered)
"p" = (/obj/item/stack/sheet/mineral/plasma/twenty,/obj/structure/table,/turf/open/floor/plating/rust,/area/ruin/unpowered)
"q" = (/obj/item/trash/can{pixel_y = -6},/turf/open/floor/plating/wasteland/lit,/area/overmap_encounter/planetoid/wasteland)
"r" = (/turf/open/floor/plating/rust,/area/ruin/unpowered)
"s" = (/turf/open/floor/plating,/area/ruin/unpowered)
"t" = (/obj/structure/table,/obj/item/reagent_containers/food/drinks/bottle/sarsaparilla,/turf/open/floor/plating/rust,/area/ruin/unpowered)
"u" = (/obj/structure/tank_dispenser/oxygen,/turf/open/floor/plating/rust,/area/ruin/unpowered)
"v" = (/obj/item/stack/sheet/mineral/titanium/fifty,/obj/structure/table,/obj/effect/decal/cleanable/dirt,/turf/open/floor/plating/rust,/area/ruin/unpowered)
"w" = (/mob/living/simple_animal/hostile/asteroid/whitesands/ranged/hunter{dir = 4; faction = list("adobe")},/obj/effect/decal/cleanable/dirt,/turf/open/floor/plating,/area/ruin/unpowered)
"x" = (/mob/living/simple_animal/hostile/asteroid/whitesands/survivor{dir = 4; faction = list("adobe")},/turf/open/floor/plating/wasteland/lit,/area/overmap_encounter/planetoid/wasteland)
"y" = (/obj/structure/table,/obj/item/clothing/glasses/meson/gar,/turf/open/floor/plating/rust,/area/ruin/unpowered)
"z" = (/obj/effect/decal/cleanable/dirt,/turf/open/floor/plating,/area/ruin/unpowered)
"A" = (/obj/item/cigbutt{pixel_x = -3; pixel_y = -1},/obj/item/cigbutt{pixel_x = -9; pixel_y = -8},/turf/open/floor/plating/wasteland/lit,/area/overmap_encounter/planetoid/wasteland)
"B" = (/turf/closed/wall,/area/ruin/unpowered)
"C" = (/obj/structure/chair/plastic,/mob/living/simple_animal/hostile/asteroid/whitesands/survivor{faction = list("adobe")},/obj/effect/decal/cleanable/dirt,/turf/open/floor/plating/wasteland/lit,/area/overmap_encounter/planetoid/wasteland)
"D" = (/mob/living/simple_animal/hostile/asteroid/whitesands/ranged/gunslinger{dir = 4; faction = list("adobe")},/turf/open/floor/plating/rust,/area/ruin/unpowered)
"E" = (/mob/living/simple_animal/hostile/asteroid/whitesands/survivor{dir = 1; faction = list("adobe")},/obj/effect/decal/cleanable/dirt,/turf/open/floor/plating,/area/ruin/unpowered)
"F" = (/obj/effect/decal/cleanable/blood/old{icon_state = "floor5-old"},/obj/effect/decal/cleanable/dirt,/turf/open/floor/plating/rust,/area/ruin/unpowered)
"G" = (/obj/structure/barricade/sandbags,/turf/open/floor/plating,/area/ruin/unpowered)
"H" = (/obj/effect/decal/cleanable/blood/old{icon_state = "floor3-old"},/obj/effect/decal/cleanable/dirt,/turf/open/floor/plating,/area/ruin/unpowered)
"I" = (/obj/structure/falsewall,/turf/open/space/basic,/area/ruin/unpowered)
"J" = (/obj/structure/sign/poster/contraband/communist_state,/turf/closed/wall/rust,/area/ruin/unpowered)
"K" = (/obj/effect/decal/cleanable/dirt,/turf/open/floor/plating/wasteland/lit,/area/overmap_encounter/planetoid/wasteland)
"L" = (/turf/closed/wall/rust,/area/whitesands/surface/outdoors)
"M" = (/turf/open/floor/plating/wasteland/lit,/area/overmap_encounter/planetoid/wasteland)
"N" = (/obj/item/stack/sheet/mineral/uranium/five,/obj/structure/table,/turf/open/floor/plating,/area/ruin/unpowered)
"O" = (/obj/structure/chair/plastic{dir = 4},/mob/living/simple_animal/hostile/asteroid/whitesands/survivor{dir = 4; faction = list("adobe")},/obj/effect/decal/cleanable/dirt,/turf/open/floor/plating/wasteland/lit,/area/overmap_encounter/planetoid/wasteland)
"P" = (/obj/structure/barricade/sandbags,/turf/open/floor/plating/dust/lit,/area/overmap_encounter/planetoid/wasteland)
"Q" = (/obj/structure/reagent_dispensers/watertank,/turf/open/floor/plating,/area/ruin/unpowered)
"R" = (/obj/effect/mob_spawn/human/corpse/damaged,/obj/effect/decal/cleanable/blood/old{icon_state = "floor2-old"},/turf/open/floor/plating/wasteland/lit,/area/overmap_encounter/planetoid/wasteland)
"S" = (/obj/machinery/door/airlock/wood/glass,/turf/open/floor/plating/rust,/area/ruin/unpowered)
"T" = (/obj/structure/barricade/sandbags,/turf/open/floor/plating/rust,/area/ruin/unpowered)
"U" = (/turf/closed/wall/rust,/area/ruin/unpowered)
"V" = (/obj/structure/table,/obj/item/radio,/obj/item/radio,/obj/item/radio,/turf/open/floor/plating/rust,/area/ruin/unpowered)
"W" = (/obj/structure/table,/obj/item/gun/ballistic/automatic/pistol/m1911,/turf/open/floor/plating/rust,/area/ruin/unpowered)
"X" = (/turf/open/floor/plating/dust/lit,/area/overmap_encounter/planetoid/wasteland)
"Y" = (/obj/machinery/door/airlock/wood/glass,/turf/open/floor/plating/rust,/area/ruin/powered)
"Z" = (/obj/structure/table,/obj/item/trash/can,/obj/item/ammo_box/c45,/turf/open/floor/plating/rust,/area/ruin/unpowered)

(1,1,1) = {"
aaaaaaaaaaaaaa
aaUBBBUUULaaaa
aaUipNuvnLaaaa
aaUysEsooLMMPP
aaUUBBSUILMMXX
aaBVWZskcgKCAX
aaUrzsrfhgOjKM
aaUtroeQmgqKMd
aaUUYJBUUBUMdd
MMUrrswGoFUMMM
XRUrDTosbHYMMM
XXUUBBUUUUUxMM
aXXMMMMMMMMMMM
aaaaaaaaaaaaaa
"}
