"ai" = (/mob/living/simple_animal/hostile/asteroid/goliath{dir = 4},/turf/open/floor/plating/wasteland/lit,/area/overmap_encounter/planetoid/wasteland)
"an" = (/obj/machinery/door/airlock,/turf/open/floor/iron/dark/smooth_half{dir = 1},/area/ruin/unpowered)
"bs" = (/obj/structure/barricade/sandbags,/turf/open/floor/plating/wasteland/lit,/area/overmap_encounter/planetoid/wasteland)
"bB" = (/obj/structure/sign/poster/contraband/steppyflag,/turf/closed/wall/r_wall,/area/ruin/unpowered)
"bE" = (/obj/item/reagent_containers/food/drinks/beer/light{pixel_y = 12},/obj/item/cigbutt{pixel_x = -10; pixel_y = 2},/obj/structure/table,/turf/open/floor/plating/wasteland/lit,/area/overmap_encounter/planetoid/wasteland)
"ca" = (/obj/machinery/shower{dir = 4},/obj/structure/curtain,/obj/effect/turf_decal/siding/thinplating/dark{dir = 5},/obj/structure/window/reinforced/spawner/north,/turf/open/floor/noslip,/area/ruin/unpowered)
"cZ" = (/obj/machinery/mineral/ore_redemption,/turf/open/floor/plating,/area/ruin/unpowered)
"dh" = (/obj/structure/chair{dir = 1},/turf/open/floor/carpet/nanoweave/red,/area/ruin/unpowered)
"dk" = (/obj/structure/ore_box,/turf/open/floor/plating/wasteland/lit,/area/overmap_encounter/planetoid/wasteland)
"dw" = (/obj/structure/ore_box,/turf/open/floor/plating/dust/lit,/area/overmap_encounter/planetoid/wasteland)
"dz" = (/obj/structure/chair/plastic{dir = 4},/obj/effect/decal/cleanable/blood,/turf/open/floor/plating/wasteland/lit,/area/overmap_encounter/planetoid/wasteland)
"dM" = (/obj/item/assembly/signaler/anomaly{name = "unknown anomaly core"},/turf/open/floor/iron/grimy,/area/ruin/unpowered)
"fL" = (/obj/item/kinetic_crusher,/obj/effect/decal/cleanable/blood,/obj/effect/gibspawner/human,/obj/item/clothing/suit/space/hardsuit/mining,/turf/open/floor/plating/dust/lit,/area/overmap_encounter/planetoid/wasteland)
"gl" = (/obj/structure/sink{dir = 8; pixel_x = 12},/obj/structure/mirror{pixel_x = 26},/turf/open/floor/iron/white/small,/area/ruin/unpowered)
"gN" = (/obj/structure/sign/poster/contraband/tools,/turf/closed/wall/r_wall,/area/ruin/unpowered)
"hD" = (/obj/machinery/computer{dir = 8},/turf/open/floor/carpet/nanoweave/red,/area/ruin/unpowered)
"iI" = (/obj/effect/gibspawner/human,/obj/structure/window/reinforced/spawner/north,/turf/open/floor/iron/grimy,/area/ruin/unpowered)
"kN" = (/obj/item/stack/ore/plasma{amount = 8},/turf/open/floor/plating/wasteland/lit,/area/overmap_encounter/planetoid/wasteland)
"lg" = (/obj/structure/table,/obj/machinery/microwave,/turf/open/floor/iron/grimy,/area/ruin/unpowered)
"ll" = (/turf/open/floor/plating/rust,/area/overmap_encounter/planetoid/wasteland)
"lq" = (/mob/living/simple_animal/hostile/nanotrasen/baton{name = "Survivor"},/turf/open/floor/iron/white/small,/area/ruin/unpowered)
"lW" = (/obj/effect/decal/cleanable/blood/splatter,/obj/effect/decal/cleanable/blood/tracks,/turf/open/floor/iron/grimy,/area/ruin/unpowered)
"mf" = (/obj/machinery/light/broken{dir = 8},/obj/structure/bed{dir = 8},/turf/open/floor/iron/grimy,/area/ruin/unpowered)
"mk" = (/turf/open/floor/iron/grimy,/area/ruin/unpowered)
"nn" = (/obj/structure/fans/tiny,/obj/machinery/door/airlock/mining,/turf/open/floor/iron/dark/smooth_half,/area/ruin/unpowered)
"oj" = (/turf/open/floor/plating/wasteland/lit,/area/overmap_encounter/planetoid/wasteland)
"ov" = (/obj/structure/sign/warning/gasmask,/turf/closed/wall/r_wall,/area/ruin/unpowered)
"pg" = (/obj/structure/flora/rock/pile,/turf/open/floor/plating/wasteland/lit,/area/overmap_encounter/planetoid/wasteland)
"pl" = (/turf/open/floor/iron/rockvault,/area/ruin/unpowered)
"pI" = (/obj/machinery/door/airlock/mining{name = "Mech Storage"},/turf/open/floor/iron/dark/smooth_half,/area/ruin/unpowered)
"pZ" = (/obj/structure/barricade/sandbags,/turf/open/floor/plating/dust/lit,/area/overmap_encounter/planetoid/wasteland)
"qj" = (/mob/living/simple_animal/hostile/netherworld/blankbody{desc = "What seems to be the remnants of what was once a human."; name = "Turned"},/turf/open/floor/plating/wasteland/lit,/area/overmap_encounter/planetoid/wasteland)
"qw" = (/obj/item/gun/ballistic/automatic/pistol/m1911,/obj/effect/decal/cleanable/blood,/turf/open/floor/iron/grimy,/area/ruin/unpowered)
"ro" = (/obj/effect/decal/cleanable/oil,/turf/open/floor/iron/dark/small,/area/ruin/unpowered)
"rr" = (/obj/structure/sign/warning/xeno_mining,/turf/closed/wall/r_wall,/area/ruin/unpowered)
"rV" = (/obj/effect/decal/cleanable/blood,/turf/open/floor/plating/wasteland/lit,/area/overmap_encounter/planetoid/wasteland)
"rY" = (/mob/living/simple_animal/hostile/netherworld/blankbody{desc = "What seems to be the remnants of what was once a human."; name = "Turned"},/turf/open/floor/iron/grimy,/area/ruin/unpowered)
"sj" = (/obj/machinery/computer/mech_bay_power_console{dir = 8},/turf/open/floor/iron/rockvault,/area/ruin/unpowered)
"sJ" = (/obj/effect/gibspawner/human,/turf/open/floor/iron/grimy,/area/ruin/unpowered)
"sM" = (/obj/structure/flora/rock/pile,/turf/open/floor/plating/dust/lit,/area/overmap_encounter/planetoid/wasteland)
"sP" = (/mob/living/simple_animal/hostile/skeleton/plasmaminer,/turf/open/floor/plating/wasteland/lit,/area/overmap_encounter/planetoid/wasteland)
"tN" = (/turf/open/floor/plating/dust/lit,/area/overmap_encounter/planetoid/wasteland)
"ub" = (/obj/machinery/door/airlock{name = "Restroom"},/obj/structure/barricade/wooden/crude,/obj/effect/decal/cleanable/blood/tracks,/turf/open/floor/iron/dark/smooth_half,/area/ruin/unpowered)
"ue" = (/obj/structure/closet/cabinet,/turf/open/floor/iron/grimy,/area/ruin/unpowered)
"ug" = (/obj/machinery/suit_storage_unit/mining,/turf/open/floor/iron/dark/small,/area/ruin/unpowered)
"uq" = (/obj/machinery/suit_storage_unit/open,/turf/open/floor/iron/dark/small,/area/ruin/unpowered)
"ur" = (/obj/structure/flora/rock,/turf/open/floor/plating/wasteland/lit,/area/overmap_encounter/planetoid/wasteland)
"vE" = (/obj/machinery/door/airlock/security/glass{name = "Security Post"},/turf/open/floor/iron/dark/smooth_half,/area/ruin/unpowered)
"vK" = (/obj/machinery/door/airlock/mining,/obj/structure/fans/tiny,/turf/open/floor/iron/dark/smooth_half,/area/ruin/unpowered)
"vY" = (/obj/structure/table,/turf/open/floor/carpet/nanoweave/red,/area/ruin/unpowered)
"wY" = (/obj/structure/table,/obj/item/stack/sheet/cardboard,/turf/open/floor/iron/grimy,/area/ruin/unpowered)
"yb" = (/obj/effect/spawner/structure/window/reinforced,/turf/open/floor/plating,/area/ruin/unpowered)
"yv" = (/turf/open/floor/iron/dark/small,/area/ruin/unpowered)
"yz" = (/obj/structure/sign/poster/official/no_erp,/turf/closed/wall/r_wall,/area/ruin/unpowered)
"yT" = (/obj/item/chair{dir = 4},/turf/open/floor/carpet/nanoweave/red,/area/ruin/unpowered)
"yZ" = (/turf/closed/mineral/random/high_chance/wasteland,/area/overmap_encounter/planetoid/wasteland)
"zQ" = (/obj/machinery/door/poddoor/shutters/preopen,/turf/open/floor/iron/dark/smooth_half{dir = 1},/area/ruin/unpowered)
"BR" = (/obj/effect/decal/cleanable/oil,/turf/open/floor/iron/rockvault,/area/ruin/unpowered)
"Ch" = (/obj/machinery/mineral/equipment_vendor,/turf/open/floor/iron/dark/small,/area/ruin/unpowered)
"Ck" = (/obj/structure/window/reinforced/spawner/north,/turf/open/floor/iron/grimy,/area/ruin/unpowered)
"CL" = (/obj/structure/sign/poster/random,/turf/closed/wall/r_wall,/area/ruin/unpowered)
"CX" = (/obj/machinery/portable_atmospherics/canister/oxygen,/obj/machinery/light/broken{dir = 4},/turf/open/floor/iron/dark/small,/area/ruin/unpowered)
"Du" = (/obj/structure/sign/poster/contraband/space_up,/turf/closed/wall/r_wall,/area/ruin/unpowered)
"Fl" = (/obj/effect/gibspawner/human/bodypartless,/obj/structure/bed{dir = 8},/turf/open/floor/iron/grimy,/area/ruin/unpowered)
"Gc" = (/mob/living/simple_animal/hostile/asteroid/goliath,/turf/open/floor/plating/dust/lit,/area/overmap_encounter/planetoid/wasteland)
"Gh" = (/obj/structure/tank_dispenser/oxygen,/turf/open/floor/iron/dark/small,/area/ruin/unpowered)
"HW" = (/obj/machinery/light/broken{dir = 4},/turf/open/floor/iron/grimy,/area/ruin/unpowered)
"Ij" = (/obj/machinery/computer,/turf/open/floor/carpet/nanoweave/red,/area/ruin/unpowered)
"Jz" = (/obj/effect/decal/cleanable/blood,/mob/living/simple_animal/hostile/netherworld/blankbody{desc = "What seems to be the remnants of what was once a human."; name = "Turned"},/turf/open/floor/plating/wasteland/lit,/area/overmap_encounter/planetoid/wasteland)
"JC" = (/obj/item/weldingtool,/obj/effect/decal/cleanable/blood/gibs/up,/turf/open/floor/iron/rockvault,/area/ruin/unpowered)
"LJ" = (/obj/effect/decal/cleanable/blood,/obj/structure/closet/cabinet,/turf/open/floor/iron/grimy,/area/ruin/unpowered)
"LZ" = (/obj/effect/decal/cleanable/blood,/turf/open/floor/iron/grimy,/area/ruin/unpowered)
"Mh" = (/obj/structure/window/reinforced/spawner/north,/obj/structure/table,/turf/open/floor/iron/grimy,/area/ruin/unpowered)
"MW" = (/obj/effect/decal/cleanable/blood,/obj/item/anomaly_neutralizer,/turf/open/floor/iron/grimy,/area/ruin/unpowered)
"NV" = (/obj/machinery/light/broken,/obj/effect/decal/cleanable/blood,/turf/open/floor/iron/rockvault,/area/ruin/unpowered)
"OB" = (/obj/structure/chair{dir = 8},/obj/effect/decal/cleanable/blood,/turf/open/floor/iron/grimy,/area/ruin/unpowered)
"OE" = (/obj/structure/bed{dir = 8},/turf/open/floor/iron/grimy,/area/ruin/unpowered)
"OQ" = (/obj/effect/turf_decal/dept/mining,/turf/open/floor/iron/dark/small,/area/ruin/unpowered)
"Pk" = (/turf/closed/wall/r_wall,/area/overmap_encounter/planetoid/wasteland)
"Pn" = (/obj/item/reagent_containers/food/snacks/donkpocket/warm/berry,/obj/effect/decal/cleanable/blood/gibs/core,/obj/effect/decal/cleanable/blood,/turf/open/floor/iron/grimy,/area/ruin/unpowered)
"Pz" = (/obj/effect/decal/cleanable/blood,/turf/open/floor/iron/rockvault,/area/ruin/unpowered)
"PJ" = (/obj/structure/table/wood,/obj/item/toy/cards/deck{pixel_x = 3; pixel_y = 6},/turf/open/floor/iron/grimy,/area/ruin/unpowered)
"PK" = (/obj/effect/decal/cleanable/blood,/obj/machinery/computer{dir = 1; name = "old computer"},/turf/open/floor/iron/rockvault,/area/ruin/unpowered)
"Qo" = (/obj/effect/decal/cleanable/blood,/obj/effect/mob_spawn/human/miner/explorer,/obj/item/pickaxe,/turf/open/floor/plating/dust/lit,/area/overmap_encounter/planetoid/wasteland)
"Qr" = (/obj/effect/turf_decal/rechargefloor,/obj/structure/mecha_wreckage/ripley,/turf/open/floor/iron/rockvault,/area/ruin/unpowered)
"QR" = (/mob/living/simple_animal/bot/mulebot,/turf/open/floor/plating/wasteland/lit,/area/overmap_encounter/planetoid/wasteland)
"Rk" = (/obj/effect/decal/cleanable/blood,/turf/open/floor/plating/dust/lit,/area/overmap_encounter/planetoid/wasteland)
"SC" = (/obj/structure/table,/obj/item/reagent_containers/food/drinks/soda_cans/cola{pixel_x = 8; pixel_y = 5},/obj/item/toy/figure/miner{pixel_x = -5},/obj/machinery/light/broken{dir = 4},/turf/open/floor/iron/grimy,/area/ruin/unpowered)
"SP" = (/obj/structure/toilet{dir = 8},/turf/open/floor/iron/white/small,/area/ruin/unpowered)
"Tt" = (/obj/structure/table,/obj/item/ammo_box/c45,/turf/open/floor/carpet/nanoweave/red,/area/ruin/unpowered)
"TI" = (/obj/item/chair,/obj/effect/decal/cleanable/blood,/turf/open/floor/iron/grimy,/area/ruin/unpowered)
"Ur" = (/turf/open/floor/carpet/nanoweave/red,/area/ruin/unpowered)
"Uu" = (/obj/machinery/light/broken{dir = 1},/obj/effect/decal/cleanable/oil,/turf/open/floor/iron/rockvault,/area/ruin/unpowered)
"Vw" = (/turf/closed/wall/r_wall,/area/ruin/unpowered)
"VL" = (/obj/machinery/mech_bay_recharge_port{dir = 2},/turf/open/floor/iron/rockvault,/area/ruin/unpowered)
"VM" = (/obj/structure/table,/turf/open/floor/iron/white/small,/area/ruin/unpowered)
"Wf" = (/obj/effect/decal/cleanable/blood,/obj/item/clothing/glasses/material/mining/gar,/turf/open/floor/plating/dust/lit,/area/overmap_encounter/planetoid/wasteland)
"Wm" = (/obj/machinery/door/poddoor/shutters,/turf/open/floor/iron/dark/smooth_half{dir = 1},/area/ruin/unpowered)
"Wv" = (/obj/structure/marker_beacon,/turf/open/floor/plating/wasteland/lit,/area/overmap_encounter/planetoid/wasteland)
"Wz" = (/obj/item/broken_bottle,/obj/effect/decal/cleanable/blood/gibs/body,/turf/open/floor/iron/grimy,/area/ruin/unpowered)
"YN" = (/obj/effect/decal/cleanable/blood,/obj/structure/window/reinforced/spawner/north,/turf/open/floor/iron/grimy,/area/ruin/unpowered)
"YS" = (/obj/item/weldingtool,/obj/effect/decal/cleanable/blood/splatter,/obj/effect/decal/cleanable/blood/tracks,/turf/open/floor/iron/white/small,/area/ruin/unpowered)
"YW" = (/obj/structure/barricade/wooden,/turf/open/floor/plating/dust/lit,/area/overmap_encounter/planetoid/wasteland)
"Zp" = (/obj/structure/marker_beacon,/turf/open/floor/plating/dust/lit,/area/overmap_encounter/planetoid/wasteland)

(1,1,1) = {"
yZyZyZyZyZyZyZyZyZyZyZyZyZyZyZyZyZyZyZyZyZyZyZyZyZyZyZyZllll
yZtNGcojyZllllyZyZyZyZllllllllyZyZyZyZllojtNtNtNtNyZyZyZllll
yZyZsMRkQoRkaiojojojojojWvojojojojojojojojyZyZyZojtNZptNtNoj
yZyZyZyZyZyZyZyZyZyZllurojllllyZyZyZyZyZyZyZyZyZyZyZyZyZllll
VwVwVwVwVwVwVwVwCLVwVwVwtNtNyZyZVwVwVwVwVwVwyZyZyZyZyZyZyZyZ
VwMhYNueLJueVwTIPJOBmkVwYWYWyZyZVwvYIjvYTtybtNtNtNllllllyZyZ
yzOErYmkmkmkanWzmkPnHWgNYWtNyZyZVwUrdhyThDyblllltNtNtNtNtNZp
VwMhiIdMmkmkVwmkqwrYmkVwWvtNllllVwUrUrUrvYybllWvojVwpIVwVwVw
VwmfmkmkMWSCDumklWlgwYVwsPtNllllVwybvEybybVwojrVojVwPzUuVLVw
VwMhCkmkmksJVwVwubVwVwVwojojtNojojQRojojojojpgojtNWmplJCQrVw
VwFlLZmkmkrYVwVMYSglVwllojojpgojojojojrVojojojojtNzQplBRsjVw
VwbBVwvKVwCLVwcalqSPVwllllojojojojllojllojojqjrVtNVwPKNVplVw
yZVwugyvGhVwVwVwVwVwVwllojojojtNllllojyZllojojojojVwVwCLVwVw
yZVwuqroCXVwlltNcZtNojojojojtNojllllWvyZyZojojyZyZyZllllllll
yZVwugOQChVwllojtNkNojojurtNtNZpyZllojyZyZojllyZyZtNllojojWv
yZPkrrnnovPkbEojbsojojojtNtNyZRkyZyZojyZyZojyZyZtNsMojqjojll
yZyZWvojojdkdzojbsWvojojtNtNyZtNyZyZojyZyZWvyZyZtNWfojojrVyZ
llbsojojtNtNojojbsllojojllllyZtNyZyZojyZyZojyZyZyZtNojojdwyZ
llbsojbspZtNpgllllllojojllllyZtNyZyZojyZyZtNsMyZyZojojfLtNyZ
llllojojojtNtNpZyZyZpgojyZyZyZRkojyZojyZyZojllyZyZllWvtNpgyZ
yZyZojojllyZtNZpyZyZojojyZyZyZtNJzyZWvyZyZojtNojojrVojtNllyZ
yZyZWvojyZyZpZtNyZyZojWvyZyZyZyZyZyZojyZyZojllllyZyZyZyZyZyZ
"}
