//MAP CONVERTED BY dmm2tgm.py THIS HEADER COMMENT PREVENTS RECONVERSION, DO NOT REMOVE
"aa" = (
/obj/structure/rack,
/obj/item/ammo_box/a12g/rubbershot,
/obj/effect/decal/cleanable/dirt,
/obj/machinery/light/broken{
	dir = 4
	},
/turf/open/floor/plastic,
/area/ruin/powered)
"aU" = (
/obj/structure/rack,
/turf/open/floor/iron/dark/herringbone,
/area/ruin/powered)
"aW" = (
/turf/open/floor/wood/parquet,
/area/ruin/powered)
"bd" = (
/turf/open/floor/plating/wasteland/lit,
/area/overmap_encounter/planetoid/wasteland)
"bf" = (
/obj/effect/decal/cleanable/dirt/dust,
/turf/open/floor/wood/parquet,
/area/ruin/powered)
"bh" = (
/obj/structure/filingcabinet/security,
/turf/open/floor/wood/parquet,
/area/ruin/powered)
"bi" = (
/obj/effect/decal/cleanable/dirt,
/mob/living/simple_animal/hostile/nanotrasen/ranged/smg,
/turf/open/floor/plastic,
/area/ruin/powered)
"bo" = (
/obj/structure/grille/broken,
/obj/item/shard{
	icon_state = "medium"
	},
/obj/effect/decal/cleanable/glass,
/turf/open/floor/plating,
/area/ruin/powered)
"bz" = (
/obj/item/ammo_casing/c45,
/obj/item/ammo_casing/spent,
/obj/item/ammo_casing/spent,
/turf/open/floor/iron/dark/herringbone,
/area/ruin/powered)
"ct" = (
/turf/template_noop,
/area/template_noop)
"dk" = (
/obj/structure/rack,
/obj/item/ammo_box/c10mm/surplus,
/turf/open/floor/plastic,
/area/ruin/powered)
"dl" = (
/turf/closed/wall/r_wall,
/area/ruin/powered)
"dw" = (
/obj/structure/rack,
/obj/item/ammo_box/magazine/m45,
/turf/open/floor/plastic,
/area/ruin/powered)
"ew" = (
/obj/structure/rack,
/obj/item/ammo_box/c9mm,
/obj/effect/decal/cleanable/dirt,
/obj/machinery/light/broken{
	dir = 4
	},
/turf/open/floor/iron/dark/herringbone,
/area/ruin/powered)
"eH" = (
/obj/effect/decal/cleanable/dirt/dust,
/obj/effect/decal/cleanable/blood/splatter,
/obj/structure/fluff/paper/stack{
	dir = 4;
	pixel_y = -1
	},
/turf/open/floor/wood/tile,
/area/ruin/powered)
"eU" = (
/obj/structure/table,
/obj/machinery/button/door{
	id = "nt_ammo_ware";
	name = "Warehouse Blast Door Control"
	},
/obj/effect/decal/cleanable/dirt/dust,
/turf/open/floor/wood/parquet,
/area/ruin/powered)
"eZ" = (
/obj/structure/rack,
/obj/effect/decal/cleanable/dirt,
/turf/open/floor/plastic,
/area/ruin/powered)
"fm" = (
/obj/effect/decal/cleanable/dirt,
/turf/open/floor/plastic,
/area/ruin/powered)
"ga" = (
/obj/effect/decal/cleanable/dirt,
/turf/open/floor/iron/dark/herringbone,
/area/ruin/powered)
"gy" = (
/obj/structure/rack,
/turf/open/floor/plastic,
/area/ruin/powered)
"gF" = (
/obj/structure/rack,
/obj/item/ammo_box/c556mmHITP/surplus,
/turf/open/floor/plastic,
/area/ruin/powered)
"gG" = (
/obj/machinery/door/airlock/highsecurity{
	name = "Secure Ammunition Storage"
	},
/turf/open/floor/iron/dark/smooth_half,
/area/ruin/powered)
"gK" = (
/obj/structure/window/reinforced/fulltile,
/obj/structure/grille,
/turf/open/floor/plating,
/area/ruin/powered)
"hs" = (
/obj/structure/rack,
/obj/item/ammo_box/a12g/beanbag,
/obj/effect/decal/cleanable/dirt,
/turf/open/floor/plastic,
/area/ruin/powered)
"hw" = (
/obj/structure/table,
/obj/item/ammo_box/magazine/wt550m9/ap,
/turf/open/floor/wood/parquet,
/area/ruin/powered)
"hA" = (
/obj/effect/decal/cleanable/blood/splatter,
/obj/effect/decal/cleanable/dirt,
/turf/open/floor/plastic,
/area/ruin/powered)
"ia" = (
/obj/structure/fans/tiny,
/obj/machinery/door/poddoor{
	id = "nt_ammo_ware";
	name = "Nanotrasen Ammunition Warehouse Blast Doors:"
	},
/obj/effect/turf_decal/industrial/warning,
/obj/effect/turf_decal/industrial/warning{
	dir = 1
	},
/turf/open/floor/iron/dark/smooth_half,
/area/ruin/powered)
"jw" = (
/obj/item/ammo_casing/spent,
/obj/item/ammo_casing/spent,
/obj/effect/decal/cleanable/blood,
/obj/effect/mob_spawn/human/corpse/syndicatesoldier,
/obj/machinery/light/broken{
	dir = 8
	},
/turf/open/floor/plastic,
/area/ruin/powered)
"ka" = (
/obj/item/ammo_box/magazine/m10mm,
/turf/open/floor/plastic,
/area/ruin/powered)
"km" = (
/obj/structure/rack,
/obj/item/ammo_box/c38,
/obj/effect/decal/cleanable/dirt,
/turf/open/floor/iron,
/area/ruin/powered)
"mV" = (
/obj/item/ammo_casing/spent,
/obj/item/ammo_casing/spent,
/obj/item/gun/ballistic/automatic/pistol,
/obj/effect/decal/cleanable/blood/splatter,
/obj/effect/decal/cleanable/dirt,
/turf/open/floor/plastic,
/area/ruin/powered)
"os" = (
/obj/item/ammo_casing/spent,
/obj/item/ammo_casing/spent,
/obj/item/ammo_casing/spent,
/obj/effect/decal/cleanable/dirt,
/turf/open/floor/plastic,
/area/ruin/powered)
"oN" = (
/obj/item/ammo_box/a4570,
/turf/open/floor/iron/dark/herringbone,
/area/ruin/powered)
"pl" = (
/obj/effect/decal/cleanable/blood{
	icon_state = "floor4"
	},
/obj/effect/mob_spawn/human/corpse/nanotrasensoldier/smg,
/obj/effect/decal/cleanable/dirt,
/turf/open/floor/iron/dark/herringbone,
/area/ruin/powered)
"pV" = (
/obj/effect/decal/cleanable/dirt/dust,
/obj/structure/table,
/turf/open/floor/wood/parquet,
/area/ruin/powered)
"pZ" = (
/obj/item/ammo_casing/spent,
/obj/effect/decal/cleanable/dirt,
/turf/open/floor/iron/dark/herringbone,
/area/ruin/powered)
"qa" = (
/obj/machinery/icecream_vat,
/obj/item/shovel/spoon,
/turf/open/floor/plating/dust/lit,
/area/overmap_encounter/planetoid/wasteland)
"sl" = (
/obj/item/ammo_casing/c10mm,
/obj/item/ammo_casing/spent,
/obj/item/ammo_casing/spent,
/obj/item/ammo_casing/spent,
/obj/effect/decal/cleanable/dirt,
/turf/open/floor/plastic,
/area/ruin/powered)
"sv" = (
/obj/item/ammo_casing/spent,
/obj/item/ammo_casing/spent,
/obj/item/rack_parts,
/obj/effect/decal/cleanable/dirt,
/turf/open/floor/plastic,
/area/ruin/powered)
"sw" = (
/obj/item/gun/ballistic/automatic/pistol/m1911,
/obj/effect/decal/cleanable/blood/splatter{
	icon_state = "gibbl5"
	},
/turf/open/floor/plastic,
/area/ruin/powered)
"tl" = (
/obj/item/bodypart/r_arm,
/obj/structure/window/reinforced/fulltile,
/obj/structure/grille,
/turf/open/floor/plating,
/area/ruin/powered)
"ud" = (
/obj/machinery/door/airlock/engineering{
	name = "Maintenance Closet"
	},
/turf/open/floor/iron/dark/smooth_half,
/area/ruin/powered)
"uP" = (
/obj/effect/decal/cleanable/dirt,
/turf/closed/wall/r_wall,
/area/ruin/powered)
"vO" = (
/obj/item/ammo_casing/c10mm,
/obj/item/ammo_casing/spent,
/turf/open/floor/plastic,
/area/ruin/powered)
"vV" = (
/obj/item/ammo_casing/c45,
/turf/open/floor/plastic,
/area/ruin/powered)
"vZ" = (
/obj/item/gun/ballistic/automatic/pistol/m1911,
/obj/effect/decal/cleanable/blood{
	icon_state = "floor3"
	},
/obj/item/ammo_casing/spent,
/obj/effect/decal/cleanable/dirt,
/turf/open/floor/iron/dark/herringbone,
/area/ruin/powered)
"wr" = (
/obj/structure/table,
/obj/item/storage/toolbox/electrical,
/turf/open/floor/iron,
/area/ruin/powered)
"xd" = (
/obj/item/grenade/syndieminibomb,
/obj/effect/decal/cleanable/dirt/dust,
/turf/open/floor/wood/parquet,
/area/ruin/powered)
"ys" = (
/obj/machinery/light/broken{
	dir = 1
	},
/obj/structure/table,
/obj/item/stack/sheet/plastic/fifty{
	pixel_y = 5
	},
/turf/open/floor/iron,
/area/ruin/powered)
"zb" = (
/obj/machinery/computer{
	desc = "A computer long since rendered non-functional due to lack of maintenance. Spitting out error messages.";
	dir = 1;
	name = "Broken Computer"
	},
/turf/open/floor/wood/tile,
/area/ruin/powered)
"zM" = (
/obj/effect/mob_spawn/human/corpse/syndicatesoldier,
/obj/effect/decal/cleanable/blood{
	icon_state = "floor4"
	},
/obj/effect/decal/cleanable/dirt/dust,
/turf/open/floor/wood/parquet,
/area/ruin/powered)
"Az" = (
/obj/item/ammo_casing/a357,
/obj/effect/decal/cleanable/blood{
	icon_state = "floor7"
	},
/turf/open/floor/plastic,
/area/ruin/powered)
"AE" = (
/obj/structure/table,
/obj/item/paper_bin{
	pixel_y = 5
	},
/obj/item/pen{
	pixel_y = 5
	},
/turf/open/floor/wood/parquet,
/area/ruin/powered)
"Bl" = (
/obj/effect/decal/cleanable/blood,
/obj/effect/mob_spawn/human/corpse/syndicatesoldier,
/turf/open/floor/plastic,
/area/ruin/powered)
"BI" = (
/obj/item/ammo_casing/spent,
/obj/effect/decal/cleanable/dirt,
/turf/open/floor/iron/dark/small,
/area/ruin/powered)
"BR" = (
/obj/structure/table,
/obj/item/storage/toolbox/mechanical,
/obj/effect/decal/cleanable/dirt,
/turf/open/floor/iron,
/area/ruin/powered)
"Cb" = (
/obj/structure/rack,
/obj/item/ammo_box/a12g,
/turf/open/floor/iron/dark/herringbone,
/area/ruin/powered)
"Cq" = (
/obj/structure/rack,
/obj/item/ammo_box/c9mm/surplus,
/obj/effect/decal/cleanable/dirt,
/turf/open/floor/plastic,
/area/ruin/powered)
"CD" = (
/obj/structure/rack,
/obj/effect/decal/cleanable/dirt,
/turf/open/floor/iron/dark/herringbone,
/area/ruin/powered)
"CU" = (
/obj/structure/table,
/obj/effect/decal/cleanable/dirt/dust,
/obj/item/ammo_box/magazine/wt550m9,
/turf/open/floor/wood/parquet,
/area/ruin/powered)
"CZ" = (
/obj/item/ammo_casing/a50,
/obj/item/ammo_casing/spent,
/obj/item/ammo_casing/spent,
/obj/effect/decal/cleanable/dirt,
/turf/open/floor/plastic,
/area/ruin/powered)
"DM" = (
/obj/structure/chair/office{
	dir = 4
	},
/obj/effect/decal/cleanable/dirt/dust,
/obj/machinery/light/broken{
	dir = 8
	},
/obj/effect/mob_spawn/human/corpse/nanotrasensoldier,
/obj/effect/decal/cleanable/blood,
/turf/open/floor/wood/tile,
/area/ruin/powered)
"Eg" = (
/obj/structure/rack,
/obj/item/ammo_box/c9mm,
/turf/open/floor/iron/dark/herringbone,
/area/ruin/powered)
"EC" = (
/mob/living/simple_animal/hostile/asteroid/whitesands/ranged/hunter,
/turf/open/floor/plating/wasteland/lit,
/area/overmap_encounter/planetoid/wasteland)
"Fi" = (
/obj/machinery/autolathe,
/obj/machinery/camera{
	dir = 5
	},
/turf/open/floor/iron,
/area/ruin/powered)
"FB" = (
/turf/closed/wall,
/area/ruin/powered)
"Hi" = (
/obj/machinery/door/airlock/security{
	name = "Security Office"
	},
/obj/effect/turf_decal/siding/wood{
	dir = 1
	},
/turf/open/floor/iron/dark/smooth_half,
/area/ruin/powered)
"Hl" = (
/obj/machinery/light/broken{
	dir = 1
	},
/obj/item/ammo_casing/spent,
/obj/item/ammo_casing/spent,
/obj/effect/decal/cleanable/dirt,
/turf/open/floor/plastic,
/area/ruin/powered)
"HA" = (
/turf/open/floor/iron,
/area/ruin/powered)
"HS" = (
/obj/item/shard,
/obj/effect/decal/cleanable/glass,
/turf/open/floor/plastic,
/area/ruin/powered)
"Ij" = (
/obj/item/ammo_casing/c9mm,
/turf/open/floor/iron/dark/herringbone,
/area/ruin/powered)
"Is" = (
/obj/effect/decal/cleanable/blood/splatter,
/obj/item/ammo_casing/spent,
/obj/effect/decal/cleanable/dirt/dust,
/turf/open/floor/wood/parquet,
/area/ruin/powered)
"Iy" = (
/obj/item/ammo_casing/a357,
/obj/effect/decal/cleanable/dirt,
/turf/open/floor/iron/dark/herringbone,
/area/ruin/powered)
"IH" = (
/turf/closed/wall/rust,
/area/ruin/powered)
"Jb" = (
/obj/machinery/light/broken,
/obj/item/ammo_casing/spent,
/obj/effect/decal/cleanable/blood{
	icon_state = "floor2"
	},
/obj/effect/mob_spawn/human/corpse/nanotrasensoldier/ranged,
/obj/effect/decal/cleanable/dirt,
/turf/open/floor/plastic,
/area/ruin/powered)
"Jm" = (
/obj/machinery/camera,
/obj/item/paper{
	info = "Who put SA's ammunition in this warehouse? We don't even use 10mm, get this out of here.";
	name = "Notice"
	},
/obj/effect/decal/cleanable/dirt,
/turf/open/floor/iron/dark/herringbone,
/area/ruin/powered)
"Jt" = (
/obj/item/bodypart/head,
/turf/open/floor/plastic,
/area/ruin/powered)
"Ke" = (
/obj/structure/rack,
/obj/item/ammo_box/c556mmHITP,
/obj/effect/decal/cleanable/dirt,
/turf/open/floor/iron/dark/herringbone,
/area/ruin/powered)
"KY" = (
/obj/item/ammo_casing/c10mm,
/turf/open/floor/plastic,
/area/ruin/powered)
"Lm" = (
/obj/structure/chair/office{
	dir = 1
	},
/turf/open/floor/wood/parquet,
/area/ruin/powered)
"Lz" = (
/turf/open/floor/plating/dust/lit,
/area/overmap_encounter/planetoid/wasteland)
"Me" = (
/obj/item/ammo_box/magazine/co9mm,
/obj/effect/decal/cleanable/blood/splatter{
	icon_state = "gibbl5"
	},
/turf/open/floor/plastic,
/area/ruin/powered)
"Mu" = (
/obj/item/ammo_casing/spent,
/obj/item/ammo_casing/spent,
/turf/open/floor/iron/dark/herringbone,
/area/ruin/powered)
"MC" = (
/obj/effect/decal/cleanable/dirt/dust,
/obj/structure/fluff/paper/stack{
	dir = 10;
	pixel_y = -1
	},
/turf/open/floor/wood/parquet,
/area/ruin/powered)
"MG" = (
/obj/item/ammo_casing/c45,
/obj/effect/decal/cleanable/glass,
/obj/effect/decal/cleanable/dirt,
/turf/open/floor/plastic,
/area/ruin/powered)
"Nd" = (
/obj/item/ammo_casing/spent,
/obj/item/ammo_casing/spent,
/obj/effect/decal/cleanable/dirt,
/turf/open/floor/plastic,
/area/ruin/powered)
"NP" = (
/obj/item/paper_bin{
	pixel_y = 5
	},
/obj/structure/table,
/obj/effect/decal/cleanable/dirt/dust,
/obj/effect/turf_decal/siding/wood{
	dir = 4
	},
/obj/item/pen{
	pixel_y = 5
	},
/turf/open/floor/wood/tile,
/area/ruin/powered)
"NR" = (
/obj/item/ammo_casing/a50,
/obj/effect/decal/cleanable/dirt,
/turf/open/floor/plastic,
/area/ruin/powered)
"NU" = (
/obj/effect/turf_decal/siding/wood{
	dir = 4
	},
/obj/effect/decal/cleanable/dirt/dust,
/obj/structure/fluff/paper/stack,
/turf/open/floor/wood/tile,
/area/ruin/powered)
"Oo" = (
/obj/item/ammo_casing/spent,
/turf/open/floor/plastic,
/area/ruin/powered)
"OJ" = (
/obj/item/ammo_casing/c9mm,
/obj/effect/decal/cleanable/glass,
/obj/item/ammo_casing/spent,
/obj/item/ammo_casing/spent,
/obj/effect/decal/cleanable/dirt,
/turf/open/floor/iron/dark/herringbone,
/area/ruin/powered)
"Pi" = (
/obj/effect/decal/cleanable/blood{
	icon_state = "floor6"
	},
/obj/effect/mob_spawn/human/corpse/nanotrasensoldier/ranged,
/turf/open/floor/plastic,
/area/ruin/powered)
"PO" = (
/obj/effect/decal/cleanable/dirt,
/turf/open/floor/iron/dark/small,
/area/ruin/powered)
"Qm" = (
/obj/effect/decal/cleanable/blood/splatter,
/obj/effect/decal/cleanable/dirt,
/turf/open/floor/iron/dark/herringbone,
/area/ruin/powered)
"Qp" = (
/obj/structure/rack,
/obj/item/ammo_box/c10mm,
/obj/effect/decal/cleanable/dirt,
/turf/open/floor/iron/dark/herringbone,
/area/ruin/powered)
"Ro" = (
/obj/structure/fans/tiny,
/obj/machinery/door/airlock/grunge{
	name = "NanoTrasen Ammunition Warehouse"
	},
/turf/open/floor/iron/dark/smooth_half,
/area/ruin/powered)
"Rz" = (
/obj/machinery/door/airlock/highsecurity{
	name = "Warehouse Access"
	},
/obj/structure/barricade/wooden/crude,
/turf/open/floor/iron/dark/smooth_half,
/area/ruin/powered)
"RG" = (
/obj/structure/rack,
/obj/item/ammo_box/c45,
/obj/effect/decal/cleanable/dirt,
/turf/open/floor/iron/dark/herringbone,
/area/ruin/powered)
"RN" = (
/obj/machinery/camera,
/obj/structure/filingcabinet,
/turf/open/floor/iron/dark/small,
/area/ruin/powered)
"Sr" = (
/obj/item/ammo_casing/spent,
/obj/item/ammo_casing/spent,
/obj/item/ammo_casing/spent,
/obj/effect/decal/cleanable/dirt,
/turf/open/floor/iron/dark/small,
/area/ruin/powered)
"Sw" = (
/obj/effect/decal/cleanable/dirt,
/turf/open/floor/iron,
/area/ruin/powered)
"ST" = (
/obj/item/ammo_box/magazine/m45,
/obj/effect/decal/cleanable/blood{
	icon_state = "floor5"
	},
/obj/effect/decal/cleanable/dirt,
/turf/open/floor/plastic,
/area/ruin/powered)
"Td" = (
/turf/open/floor/iron/dark/small,
/area/ruin/powered)
"Tt" = (
/obj/item/ammo_casing/a357,
/obj/effect/decal/cleanable/dirt,
/mob/living/simple_animal/hostile/nanotrasen/ranged,
/turf/open/floor/plastic,
/area/ruin/powered)
"TA" = (
/obj/structure/table,
/obj/effect/turf_decal/siding/wood{
	dir = 4
	},
/turf/open/floor/wood/tile,
/area/ruin/powered)
"TD" = (
/obj/effect/decal/cleanable/blood/tracks,
/turf/closed/wall/r_wall,
/area/ruin/powered)
"TM" = (
/obj/item/ammo_casing/spent,
/obj/item/rack_parts,
/obj/effect/decal/cleanable/dirt,
/turf/open/floor/plastic,
/area/ruin/powered)
"VR" = (
/turf/open/floor/plastic,
/area/ruin/powered)
"WA" = (
/obj/machinery/camera{
	dir = 1
	},
/obj/item/ammo_casing/spent,
/obj/effect/decal/cleanable/dirt,
/turf/open/floor/plastic,
/area/ruin/powered)
"Xw" = (
/obj/structure/fluff/paper/stack{
	dir = 8;
	pixel_y = -1
	},
/turf/open/floor/wood/parquet,
/area/ruin/powered)
"XL" = (
/obj/machinery/light/broken{
	dir = 1
	},
/obj/machinery/computer/security,
/turf/open/floor/wood/parquet,
/area/ruin/powered)
"Ze" = (
/obj/structure/rack,
/obj/item/ammo_box/c45/surplus,
/obj/effect/decal/cleanable/dirt,
/turf/open/floor/plastic,
/area/ruin/powered)
"Zr" = (
/obj/item/rack_parts,
/obj/effect/decal/cleanable/dirt,
/turf/open/floor/plastic,
/area/ruin/powered)

(1,1,1) = {"
ct
ct
ct
ct
ct
ct
ct
Lz
bd
bd
ct
ct
ct
ct
ct
ct
ct
ct
"}
(2,1,1) = {"
ct
ct
ct
ct
ct
ct
ct
Lz
qa
Lz
ct
ct
FB
IH
FB
IH
FB
ct
"}
(3,1,1) = {"
ct
ct
ct
ct
ct
ct
ct
bd
Lz
Lz
ct
ct
FB
eH
DM
zb
IH
ct
"}
(4,1,1) = {"
ct
dl
dl
dl
dl
dl
dl
dl
dl
dl
dl
dl
dl
NU
TA
NP
FB
bd
"}
(5,1,1) = {"
ct
dl
BR
Sw
Fi
dl
NR
ST
Oo
vO
jw
VR
Rz
Td
BI
Sr
Ro
bd
"}
(6,1,1) = {"
ct
dl
wr
Sw
HA
dl
VR
hs
Zr
dk
sv
WA
dl
RN
Td
PO
gK
bd
"}
(7,1,1) = {"
ct
dl
ys
Sw
HA
ud
Pi
sw
Tt
fm
Oo
KY
dl
dl
dl
FB
IH
bd
"}
(8,1,1) = {"
ct
dl
Sw
Sw
Sw
dl
Hl
Ze
TM
hs
Cq
Me
KY
Jt
dl
bd
Lz
Lz
"}
(9,1,1) = {"
ct
TD
HA
HA
km
dl
sl
os
os
fm
vV
Az
Oo
Oo
dl
Lz
Lz
ct
"}
(10,1,1) = {"
ct
dl
dl
dl
dl
dl
gK
gK
tl
gK
dl
bi
Nd
Jb
dl
bd
bd
ct
"}
(11,1,1) = {"
ct
dl
bh
xd
aW
dl
Eg
aU
RG
Cb
gK
MG
eZ
hA
ia
bd
EC
ct
"}
(12,1,1) = {"
ct
dl
AE
zM
Is
dl
Ij
bz
pl
OJ
bo
HS
eZ
NR
ia
bd
bd
ct
"}
(13,1,1) = {"
ct
dl
XL
Lm
bf
Hi
ga
vZ
Mu
pZ
gG
Oo
gF
ka
ia
bd
bd
ct
"}
(14,1,1) = {"
ct
dl
eU
MC
Xw
dl
Jm
Iy
oN
Qm
gK
CZ
mV
Bl
dl
bd
bd
ct
"}
(15,1,1) = {"
ct
dl
CU
hw
pV
dl
Qp
ew
CD
Ke
gK
dw
aa
gy
dl
ct
ct
ct
"}
(16,1,1) = {"
ct
dl
dl
dl
dl
dl
dl
uP
dl
dl
dl
dl
dl
dl
dl
ct
ct
ct
"}
(17,1,1) = {"
ct
ct
ct
ct
ct
ct
ct
ct
ct
ct
ct
ct
ct
ct
ct
ct
ct
ct
"}
