//MAP CONVERTED BY dmm2tgm.py THIS HEADER COMMENT PREVENTS RECONVERSION, DO NOT REMOVE
"a" = (
/turf/template_noop,
/area/template_noop)
"b" = (
/obj/machinery/door/airlock/security/glass{
	name = "Security Cell"
	},
/turf/open/floor/iron/dark/smooth_half{
	dir = 1
	},
/area/ruin/powered)
"c" = (
/obj/machinery/light,
/turf/open/floor/plating,
/area/ruin/powered)
"d" = (
/obj/effect/turf_decal/sand/plating,
/turf/open/floor/plating,
/area/ruin/unpowered)
"e" = (
/obj/machinery/light/broken,
/turf/open/floor/iron,
/area/ruin/powered)
"f" = (
/turf/open/floor/plating/dust/lit,
/area/ruin/unpowered)
"g" = (
/obj/effect/turf_decal/siding/wood{
	dir = 8
	},
/obj/structure/window/reinforced/spawner/west,
/turf/open/floor/wood/parquet,
/area/ruin/powered)
"h" = (
/mob/living/simple_animal/hostile/nanotrasen/ranged,
/turf/open/floor/plating,
/area/ruin/unpowered)
"j" = (
/obj/structure/table/reinforced,
/obj/item/reagent_containers/food/drinks/bottle/whiskey{
	pixel_x = -5;
	pixel_y = 8
	},
/obj/item/clothing/mask/gas/sechailer/swat{
	pixel_x = 7;
	pixel_y = 2
	},
/obj/effect/turf_decal/siding/wood{
	dir = 8
	},
/obj/structure/window/reinforced/spawner/west,
/turf/open/floor/wood/parquet,
/area/ruin/powered)
"k" = (
/obj/effect/mob_spawn/human/corpse/whitesands/survivor,
/obj/effect/decal/cleanable/blood,
/turf/open/floor/plating/dust/lit,
/area/ruin/unpowered)
"m" = (
/turf/open/floor/plating,
/area/ruin/unpowered)
"n" = (
/obj/effect/mob_spawn/human/corpse/whitesands/survivor,
/obj/effect/decal/cleanable/blood{
	icon_state = "floor3"
	},
/turf/open/floor/plating/wasteland/lit,
/area/ruin/unpowered)
"p" = (
/obj/structure/chair/office{
	dir = 8
	},
/turf/open/floor/iron/small,
/area/ruin/powered)
"r" = (
/obj/structure/table/reinforced,
/obj/machinery/recharger,
/turf/open/floor/iron/small,
/area/ruin/powered)
"u" = (
/turf/open/floor/plating/dust/lit,
/area/whitesands/surface/outdoors)
"v" = (
/mob/living/simple_animal/hostile/nanotrasen/baton,
/obj/effect/turf_decal/sand,
/turf/open/floor/iron,
/area/ruin/unpowered)
"w" = (
/obj/structure/table/reinforced,
/obj/effect/spawner/lootdrop/donkpockets,
/obj/effect/spawner/lootdrop/donkpockets,
/turf/open/floor/iron/small,
/area/ruin/powered)
"x" = (
/obj/structure/sink{
	dir = 4;
	pixel_x = -12
	},
/obj/machinery/light/small{
	dir = 8
	},
/obj/item/restraints/handcuffs,
/turf/open/floor/iron/small,
/area/ruin/powered)
"y" = (
/obj/structure/bed,
/obj/item/bedsheet/hos,
/obj/structure/curtain/cloth/fancy,
/turf/open/floor/wood/parquet,
/area/ruin/powered)
"z" = (
/obj/structure/table/reinforced,
/obj/machinery/microwave{
	pixel_y = 6
	},
/turf/open/floor/iron/small,
/area/ruin/powered)
"A" = (
/obj/machinery/light,
/turf/open/floor/iron/small,
/area/ruin/powered)
"B" = (
/turf/open/floor/iron/small,
/area/ruin/powered)
"C" = (
/obj/effect/turf_decal/siding/wood{
	dir = 8
	},
/obj/machinery/door/window/westleft{
	name = "Bunks"
	},
/turf/open/floor/wood/parquet,
/area/ruin/powered)
"E" = (
/turf/open/floor/plating/wasteland/lit,
/area/ruin/unpowered)
"F" = (
/obj/structure/rack,
/obj/item/clothing/suit/armor/vest/alt,
/obj/item/clothing/head/helmet/swat/nanotrasen,
/turf/open/floor/iron/small,
/area/ruin/powered)
"G" = (
/obj/structure/table/wood,
/obj/item/melee/classic_baton,
/turf/open/floor/plating,
/area/ruin/unpowered)
"H" = (
/obj/structure/closet/secure_closet/security{
	populate = 0;
	req_access = null;
	name = "gun locker"
	},
/obj/item/gun/ballistic/automatic/pistol/m1911,
/obj/item/ammo_box/magazine/m45,
/obj/item/ammo_box/magazine/m45,
/obj/item/storage/box/handcuffs,
/turf/open/floor/iron/small,
/area/ruin/powered)
"I" = (
/obj/effect/turf_decal/sand,
/turf/open/floor/iron,
/area/ruin/unpowered)
"J" = (
/obj/structure/toilet{
	dir = 4
	},
/turf/open/floor/iron/small,
/area/ruin/powered)
"K" = (
/obj/structure/barricade/sandbags,
/obj/effect/turf_decal/sand/plating,
/obj/structure/fans/tiny/invisible,
/turf/open/floor/plating,
/area/ruin/unpowered)
"L" = (
/obj/structure/bed,
/obj/effect/mob_spawn/human/corpse/syndicatesoldier,
/obj/effect/decal/cleanable/blood{
	icon_state = "floor3"
	},
/turf/open/floor/iron/small,
/area/ruin/powered)
"M" = (
/obj/structure/fans/tiny,
/obj/machinery/door/airlock/security/glass{
	name = "Private Security Outpost 64"
	},
/turf/open/floor/iron/dark/smooth_half,
/area/ruin/powered)
"N" = (
/obj/structure/table/reinforced/rglass,
/obj/item/paper_bin,
/obj/item/pen,
/turf/open/floor/iron/small,
/area/ruin/powered)
"P" = (
/obj/effect/turf_decal/siding/wood{
	dir = 8
	},
/obj/structure/window/reinforced/spawner/west,
/obj/machinery/light,
/turf/open/floor/wood/parquet,
/area/ruin/powered)
"Q" = (
/obj/structure/table/wood,
/obj/effect/turf_decal/sand,
/turf/open/floor/iron,
/area/ruin/unpowered)
"R" = (
/mob/living/simple_animal/hostile/nanotrasen/ranged/smg,
/turf/open/floor/iron/small,
/area/ruin/powered)
"S" = (
/turf/open/floor/iron,
/area/ruin/unpowered)
"T" = (
/obj/structure/table/wood,
/obj/item/ammo_box/c45,
/obj/effect/turf_decal/sand,
/turf/open/floor/iron,
/area/ruin/unpowered)
"U" = (
/turf/open/floor/plating/wasteland/lit,
/area/whitesands/surface/outdoors)
"V" = (
/obj/structure/table/wood,
/obj/item/holosign_creator/security,
/obj/effect/turf_decal/sand/plating,
/turf/open/floor/plating,
/area/ruin/unpowered)
"W" = (
/turf/closed/wall/r_wall,
/area/ruin/powered)
"X" = (
/obj/structure/table/reinforced/rglass,
/obj/item/reagent_containers/food/drinks/waterbottle/large{
	pixel_y = 8
	},
/turf/open/floor/iron/small,
/area/ruin/powered)
"Y" = (
/obj/structure/chair/office{
	dir = 4
	},
/turf/open/floor/iron/small,
/area/ruin/powered)
"Z" = (
/obj/structure/sign/departments/security,
/turf/closed/wall/r_wall,
/area/ruin/unpowered)

(1,1,1) = {"
a
a
a
a
a
a
a
a
a
a
a
a
a
"}
(2,1,1) = {"
a
a
a
a
u
u
u
a
W
W
W
W
W
"}
(3,1,1) = {"
a
a
u
u
u
U
U
U
W
L
x
J
W
"}
(4,1,1) = {"
a
u
E
k
E
E
E
E
W
W
b
W
W
"}
(5,1,1) = {"
a
f
Z
K
K
K
K
W
W
H
B
z
W
"}
(6,1,1) = {"
a
E
K
V
Q
h
d
W
r
B
B
A
W
"}
(7,1,1) = {"
a
E
K
m
d
I
c
W
w
B
Y
Y
W
"}
(8,1,1) = {"
a
E
K
v
m
S
S
M
B
R
N
X
W
"}
(9,1,1) = {"
a
E
K
m
T
G
e
W
F
B
p
p
W
"}
(10,1,1) = {"
a
f
K
d
m
d
h
W
j
C
g
P
W
"}
(11,1,1) = {"
a
E
Z
K
K
K
K
W
W
y
y
y
W
"}
(12,1,1) = {"
a
a
E
f
E
n
f
f
W
W
W
W
W
"}
(13,1,1) = {"
a
a
u
u
u
U
U
u
a
a
a
a
a
"}
(14,1,1) = {"
a
a
a
a
a
a
a
a
a
a
a
a
a
"}
(15,1,1) = {"
a
a
a
a
a
a
a
a
a
a
a
a
a
"}
(16,1,1) = {"
a
a
a
a
a
a
a
a
a
a
a
a
a
"}
